ACCOMPANY CLOCK	COMPANY O'CLOCK
ACCOMPANY COUNT	COMPANY ACCOUNT
ACCOMPANY CROSS	COMPANY ACROSS
ACCOUNT CLOCK	COUNT O'CLOCK
ACCOUNT COMPANY	COUNT ACCOMPANY
ACCOUNT CROSS	COUNT ACROSS
ACROSS CLOCK	CROSS O'CLOCK
ACROSS COMPANY	CROSS ACCOMPANY
ACROSS COUNT	CROSS ACCOUNT
AFFAIR BEND	BARE OFFEND
AFFAIR BOARD	BARE AFFORD
AFFAIR CORD	CARE AFFORD
AFFAIR FENCE	FAIR OFFENSE
AFFAIR HENCE	HAIR OFFENSE
AFFAIR RENDER	RARE OFFENDER
AFFAIR TEND	TEAR OFFEND
AFFAIR TENDER	TEAR OFFENDER
AFFAIR TRADE	TEAR AFRAID
AFFORD BEND	BOARD OFFEND
AFFORD LEND	LORD OFFEND
AFFORD SEND	SWORD OFFEND
AFFORD SENSE	SWORD OFFENSE
AFRAID TEND	TRADE OFFEND
AFRAID TENDER	TRADE OFFENDER
ALARM HEAVEN	HARM ELEVEN
ALIGN FARM	FINE ALARM
ALIGN SCIENCE	SIGN ALLIANCE
ALIGN SECTION	SIGN ELECTION
ALIGN SEVEN	SIGN ELEVEN
ALIVE FARM	FIVE ALARM
ALLIANCE SECTION	SCIENCE ELECTION
ALLIANCE SEVEN	SCIENCE ELEVEN
ALONE FARM	PHONE ALARM
ALONG SCIENCE	SONG ALLIANCE
ALONG SECTION	SONG ELECTION
ALONG SEVEN	SONG ELEVEN
AMID COUNT	KID AMOUNT
ANCHOR AGREE	OCCUR ANGRY
ANGER EAGLE	EAGER ANGLE
ANNOUNCE BLESS	BOUNCE UNLESS
APART PARENT	PART APPARENT
APART POINT	PART APPOINT
APART PROVE	PART APPROVE
APPARENT PART	PARENT APART
APPARENT POINT	PARENT APPOINT
APPARENT PROVE	PARENT APPROVE
APPEAL HEART	HEAL APART
APPEAL PARENT	PEEL APPARENT
APPEAL PART	PEEL APART
APPEAL POINT	PEEL APPOINT
APPEAL PROVE	PEEL APPROVE
APPEAR CHART	CHEER APART
APPEAR HEART	HEAR APART
APPEAR PARENT	PEER APPARENT
APPEAR PART	PEER APART
APPEAR POINT	PEER APPOINT
APPEAR PROVE	PEER APPROVE
APPLY ASSET	ALLY UPSET
APPOINT PARENT	POINT APPARENT
APPOINT PART	POINT APART
APPOINT PROVE	POINT APPROVE
APPROVE PARENT	PROVE APPARENT
APPROVE PART	PROVE APART
APPROVE POINT	PROVE APPOINT
ASIDE SALT	SIDE ASSAULT
ASIDE SLEEP	SIDE ASLEEP
ASIDE STATE	SIDE ESTATE
ASIDE WRIST	RIDE ASSIST
ASLEEP SALT	SLEEP ASSAULT
ASLEEP STATE	SLEEP ESTATE
ASSAULT FIST	FAULT ASSIST
ASSAULT SLEEP	SALT ASLEEP
ASSAULT STATE	SALT ESTATE
ASSERT DISTANCE	DIRT ASSISTANCE
ASSERT DISTANT	DIRT ASSISTANT
ASSESS LIST	LESS ASSIST
ASSIGN FAULT	FINE ASSAULT
ASSIGN FIST	FINE ASSIST
ASSIGN LIST	LINE ASSIST
ASSIGN SALT	SIGN ASSAULT
ASSIGN SLEEP	SIGN ASLEEP
ASSIGN STATE	SIGN ESTATE
ASSIST FAULT	FIST ASSAULT
ASSISTANCE DISTANT	DISTANCE ASSISTANT
ASSISTANT DISTANCE	DISTANT ASSISTANCE
ASSUME WRIST	ROOM ASSIST
ATTACH MENTION	MATCH ATTENTION
ATTACH PENSION	PATCH ATTENTION
ATTACK BEND	BACK ATTEND
ATTACK LEND	LACK ATTEND
ATTACK PENSION	PACK ATTENTION
ATTACK SEND	SACK ATTEND
ATTEND TENSION	TEND ATTENTION
ATTENTION TEND	TENSION ATTEND
AWAIT LORD	LATE AWARD
AWAKE BOARD	BAKE AWARD
AWAKE CORD	CAKE AWARD
AWAKE LORD	LAKE AWARD
AWAKE SWORD	SAKE AWARD
AWARE BOARD	BARE AWARD
AWARE CORD	CARE AWARD
BAND ANCHOR	AND BANKER
BELONG ASIDE	ALONG BESIDE
BELOW SLEEVE	SLOW BELIEVE
BESIDE ALONG	ASIDE BELONG
CAREER HUNT	HEAR CURRENT
CENT ACTION	AUNT SECTION
CENT ACTOR	AUNT SECTOR
CENT ANSWER	AUNT SENSOR
CLAIM NEARLY	NAME CLEARLY
CLAIM NEVER	NAME CLEVER
CLASS MERELY	MASS CLEARLY
CLEAN GIANT	GENE CLIENT
CLEAN MERELY	MEAN CLEARLY
CLEAR MERELY	MERE CLEARLY
CLEAR NEARLY	NEAR CLEARLY
CLEAR NEVER	NEAR CLEVER
CLEARLY NEVER	NEARLY CLEVER
CLEVER NEARLY	NEVER CLEARLY
CLOCK NEARLY	KNOCK CLEARLY
CLOCK NEVER	KNOCK CLEVER
COLLECT ELECTION	ELECT COLLECTION
COLLECTION ELECT	ELECTION COLLECT
COMMISSION IMPLY	EMISSION COMPLY
COMMISSION IMPOSE	EMISSION COMPOSE
COMMISSION INCLUDE	EMISSION CONCLUDE
COMMISSION INSIST	EMISSION CONSIST
COMMISSION INSTRUCT	EMISSION CONSTRUCT
COMMISSION INSTRUCTION	EMISSION CONSTRUCTION
COMMISSION INTEND	EMISSION CONTEND
COMMISSION INVENTION	EMISSION CONVENTION
COMPLY EMISSION	IMPLY COMMISSION
COMPLY IMPOSE	IMPLY COMPOSE
COMPLY INCLUDE	IMPLY CONCLUDE
COMPLY INSIST	IMPLY CONSIST
COMPLY INSTRUCT	IMPLY CONSTRUCT
COMPLY INSTRUCTION	IMPLY CONSTRUCTION
COMPLY INTEND	IMPLY CONTEND
COMPLY INVENTION	IMPLY CONVENTION
COMPOSE EMISSION	IMPOSE COMMISSION
COMPOSE IMPLY	IMPOSE COMPLY
COMPOSE INCLUDE	IMPOSE CONCLUDE
COMPOSE INSIST	IMPOSE CONSIST
COMPOSE INSTRUCT	IMPOSE CONSTRUCT
COMPOSE INSTRUCTION	IMPOSE CONSTRUCTION
COMPOSE INTEND	IMPOSE CONTEND
COMPOSE INVENTION	IMPOSE CONVENTION
CONCERT INSTANT	INSERT CONSTANT
CONCERT INSTANTLY	INSERT CONSTANTLY
CONCERT INSTITUTE	INSERT CONSTITUTE
CONCERT INSTITUTION	INSERT CONSTITUTION
CONCERT INSTITUTIONAL	INSERT CONSTITUTIONAL
CONCERT INTENT	INSERT CONTENT
CONCLUDE EMISSION	INCLUDE COMMISSION
CONCLUDE IMPLY	INCLUDE COMPLY
CONCLUDE IMPOSE	INCLUDE COMPOSE
CONCLUDE INSIST	INCLUDE CONSIST
CONCLUDE INSTRUCT	INCLUDE CONSTRUCT
CONCLUDE INSTRUCTION	INCLUDE CONSTRUCTION
CONCLUDE INTEND	INCLUDE CONTEND
CONCLUDE INVENTION	INCLUDE CONVENTION
CONSIST EMISSION	INSIST COMMISSION
CONSIST IMPLY	INSIST COMPLY
CONSIST IMPOSE	INSIST COMPOSE
CONSIST INCLUDE	INSIST CONCLUDE
CONSIST INSTRUCT	INSIST CONSTRUCT
CONSIST INSTRUCTION	INSIST CONSTRUCTION
CONSIST INTEND	INSIST CONTEND
CONSIST INVENTION	INSIST CONVENTION
CONSTANT INSERT	INSTANT CONCERT
CONSTANT INSTANTLY	INSTANT CONSTANTLY
CONSTANT INSTITUTE	INSTANT CONSTITUTE
CONSTANT INSTITUTION	INSTANT CONSTITUTION
CONSTANT INSTITUTIONAL	INSTANT CONSTITUTIONAL
CONSTANT INTENT	INSTANT CONTENT
CONSTANTLY INSERT	INSTANTLY CONCERT
CONSTANTLY INSTANT	INSTANTLY CONSTANT
CONSTANTLY INSTITUTE	INSTANTLY CONSTITUTE
CONSTANTLY INSTITUTION	INSTANTLY CONSTITUTION
CONSTANTLY INSTITUTIONAL	INSTANTLY CONSTITUTIONAL
CONSTANTLY INTENT	INSTANTLY CONTENT
CONSTITUTE INSERT	INSTITUTE CONCERT
CONSTITUTE INSTANT	INSTITUTE CONSTANT
CONSTITUTE INSTANTLY	INSTITUTE CONSTANTLY
CONSTITUTE INSTITUTION	INSTITUTE CONSTITUTION
CONSTITUTE INSTITUTIONAL	INSTITUTE CONSTITUTIONAL
CONSTITUTE INTENT	INSTITUTE CONTENT
CONSTITUTION INSERT	INSTITUTION CONCERT
CONSTITUTION INSTANT	INSTITUTION CONSTANT
CONSTITUTION INSTANTLY	INSTITUTION CONSTANTLY
CONSTITUTION INSTITUTE	INSTITUTION CONSTITUTE
CONSTITUTION INSTITUTIONAL	INSTITUTION CONSTITUTIONAL
CONSTITUTION INTENT	INSTITUTION CONTENT
CONSTITUTIONAL INSERT	INSTITUTIONAL CONCERT
CONSTITUTIONAL INSTANT	INSTITUTIONAL CONSTANT
CONSTITUTIONAL INSTANTLY	INSTITUTIONAL CONSTANTLY
CONSTITUTIONAL INSTITUTE	INSTITUTIONAL CONSTITUTE
CONSTITUTIONAL INSTITUTION	INSTITUTIONAL CONSTITUTION
CONSTITUTIONAL INTENT	INSTITUTIONAL CONTENT
CONSTRUCT EMISSION	INSTRUCT COMMISSION
CONSTRUCT IMPLY	INSTRUCT COMPLY
CONSTRUCT IMPOSE	INSTRUCT COMPOSE
CONSTRUCT INCLUDE	INSTRUCT CONCLUDE
CONSTRUCT INSIST	INSTRUCT CONSIST
CONSTRUCT INSTRUCTION	INSTRUCT CONSTRUCTION
CONSTRUCT INTEND	INSTRUCT CONTEND
CONSTRUCT INVENTION	INSTRUCT CONVENTION
CONSTRUCTION EMISSION	INSTRUCTION COMMISSION
CONSTRUCTION IMPLY	INSTRUCTION COMPLY
CONSTRUCTION IMPOSE	INSTRUCTION COMPOSE
CONSTRUCTION INCLUDE	INSTRUCTION CONCLUDE
CONSTRUCTION INSIST	INSTRUCTION CONSIST
CONSTRUCTION INSTRUCT	INSTRUCTION CONSTRUCT
CONSTRUCTION INTEND	INSTRUCTION CONTEND
CONSTRUCTION INVENTION	INSTRUCTION CONVENTION
CONTEND EMISSION	INTEND COMMISSION
CONTEND IMPLY	INTEND COMPLY
CONTEND IMPOSE	INTEND COMPOSE
CONTEND INCLUDE	INTEND CONCLUDE
CONTEND INSIST	INTEND CONSIST
CONTEND INSTRUCT	INTEND CONSTRUCT
CONTEND INSTRUCTION	INTEND CONSTRUCTION
CONTEND INVENTION	INTEND CONVENTION
CONTENT INSERT	INTENT CONCERT
CONTENT INSTANT	INTENT CONSTANT
CONTENT INSTANTLY	INTENT CONSTANTLY
CONTENT INSTITUTE	INTENT CONSTITUTE
CONTENT INSTITUTION	INTENT CONSTITUTION
CONTENT INSTITUTIONAL	INTENT CONSTITUTIONAL
CONVENTION EMISSION	INVENTION COMMISSION
CONVENTION IMPLY	INVENTION COMPLY
CONVENTION IMPOSE	INVENTION COMPOSE
CONVENTION INCLUDE	INVENTION CONCLUDE
CONVENTION INSIST	INVENTION CONSIST
CONVENTION INSTRUCT	INVENTION CONSTRUCT
CONVENTION INSTRUCTION	INVENTION CONSTRUCTION
CONVENTION INTEND	INVENTION CONTEND
COVER ENTRY	EVER COUNTRY
COVER OMIT	OVER COMMIT
CRACK LAZY	LACK CRAZY
CRAP LAZY	LAP CRAZY
CRAP TEACHER	TAP CREATURE
CRAWL TEACHER	TALL CREATURE
CREAM TEACHER	TEAM CREATURE
CREEK LAZY	LEAK CRAZY
CRIME TEACHER	TIME CREATURE
CROP TEACHER	TOP CREATURE
CROSS LAZY	LOSS CRAZY
CROSS TEACHER	TOSS CREATURE
CROWD LAZY	LOUD CRAZY
CROWN TEACHER	TOWN CREATURE
CRUISE LAZY	LOSE CRAZY
DECIDE APARTMENT	ASIDE DEPARTMENT
DECIDE ELITE	ASIDE DELETE
DECIDE OFFEND	ASIDE DEFEND
DECIDE OFFENDER	ASIDE DEFENDER
DECIDE OFFENSE	ASIDE DEFENSE
DECIDE OFFENSIVE	ASIDE DEFENSIVE
DEFEND APARTMENT	OFFEND DEPARTMENT
DEFEND ASIDE	OFFEND DECIDE
DEFEND ELITE	OFFEND DELETE
DEFEND OFFENDER	OFFEND DEFENDER
DEFEND OFFENSE	OFFEND DEFENSE
DEFEND OFFENSIVE	OFFEND DEFENSIVE
DEFENDER APARTMENT	OFFENDER DEPARTMENT
DEFENDER ASIDE	OFFENDER DECIDE
DEFENDER ELITE	OFFENDER DELETE
DEFENDER OFFEND	OFFENDER DEFEND
DEFENDER OFFENSE	OFFENDER DEFENSE
DEFENDER OFFENSIVE	OFFENDER DEFENSIVE
DEFENSE APARTMENT	OFFENSE DEPARTMENT
DEFENSE ASIDE	OFFENSE DECIDE
DEFENSE ELITE	OFFENSE DELETE
DEFENSE OFFEND	OFFENSE DEFEND
DEFENSE OFFENDER	OFFENSE DEFENDER
DEFENSE OFFENSIVE	OFFENSE DEFENSIVE
DEFENSIVE APARTMENT	OFFENSIVE DEPARTMENT
DEFENSIVE ASIDE	OFFENSIVE DECIDE
DEFENSIVE ELITE	OFFENSIVE DELETE
DEFENSIVE OFFEND	OFFENSIVE DEFEND
DEFENSIVE OFFENDER	OFFENSIVE DEFENDER
DEFENSIVE OFFENSE	OFFENSIVE DEFENSE
DELETE APARTMENT	ELITE DEPARTMENT
DELETE ASIDE	ELITE DECIDE
DELETE OFFEND	ELITE DEFEND
DELETE OFFENDER	ELITE DEFENDER
DELETE OFFENSE	ELITE DEFENSE
DELETE OFFENSIVE	ELITE DEFENSIVE
DEPARTMENT ASIDE	APARTMENT DECIDE
DEPARTMENT ELITE	APARTMENT DELETE
DEPARTMENT OFFEND	APARTMENT DEFEND
DEPARTMENT OFFENDER	APARTMENT DEFENDER
DEPARTMENT OFFENSE	APARTMENT DEFENSE
DEPARTMENT OFFENSIVE	APARTMENT DEFENSIVE
DEPEND SPENDING	SPEND DEPENDING
DEPENDING SPEND	SPENDING DEPEND
DIRECTION SECTOR	SECTION DIRECTOR
DIRECTOR SECTION	SECTOR DIRECTION
DRAIN CHUNK	CHAIN DRUNK
DRAIN GIFT	GAIN DRIFT
DRAIN LIFT	LANE DRIFT
DRAIN LINK	LANE DRINK
DRAIN MAMA	MAIN DRAMA
DRAIN PINK	PAIN DRINK
DRAWER MAMA	MORE DRAMA
DRAWER PINK	POUR DRINK
DRAWER SHIFT	SHORE DRIFT
DRAWER WAGON	WAR DRAGON
DREAM SINK	SEEM DRINK
DREAM THINK	THEME DRINK
DRESS GIFT	GUESS DRIFT
DRESS LIFT	LESS DRIFT
DRESS LINK	LESS DRINK
DRESS MAMA	MESS DRAMA
DRIFT LINK	LIFT DRINK
DRILL MAMA	MILL DRAMA
DRILL PINK	PILL DRINK
DRILL WAGON	WILL DRAGON
DRINK LIFT	LINK DRIFT
DRIVE LIFT	LIVE DRIFT
DRIVE LINK	LIVE DRINK
DROP CHUNK	CHOP DRUNK
DROP PINK	POP DRINK
DROP SHIFT	SHOP DRIFT
DRUM SINK	SOME DRINK
DRUM THINK	THUMB DRINK
EDIT BUTTER	BUT EDITOR
EDITION MISSION	MISSION ADDITION
ELECTION SCIENCE	SECTION ALLIANCE
ELECTION SEVEN	SECTION ELEVEN
ELEVEN HARM	HEAVEN ALARM
ELEVEN SCIENCE	SEVEN ALLIANCE
ELEVEN SECTION	SEVEN ELECTION
ELITE CHARM	CHEAT ALARM
ELITE HARM	HEAT ALARM
ELITE HEAVEN	HEAT ELEVEN
ELITE SCIENCE	SEAT ALLIANCE
ELITE SECTION	SEAT ELECTION
ELITE SEVEN	SEAT ELEVEN
EMISSION MOTION	MISSION EMOTION
EMOTION MISSION	MOTION EMISSION
ENOUGH TABLE	TOUGH UNABLE
ESTATE SALT	STATE ASSAULT
ESTATE SLEEP	STATE ASLEEP
EVENT SOLVE	CENT EVOLVE
EVOLVE CENT	SOLVE EVENT
FACT ACTOR	ACT FACTOR
FICTION ANGER	ACTION FINGER
FIND ENDING	END FINDING
FINGER ACTION	ANGER FICTION
FRAME SEND	SAME FRIEND
FREAK LEND	LEAK FRIEND
FREAK SEND	SEEK FRIEND
FREEZE SEND	SEIZE FRIEND
FRENCH BEND	BENCH FRIEND
FRIEND BENCH	BEND FRENCH
FROM SEND	SOME FRIEND
FRUIT BENCH	BOOT FRENCH
FRUIT BEND	BOOT FRIEND
FRUIT SEND	SUIT FRIEND
FUND ENDING	END FUNDING
FUNNY ENDING	ANY FUNDING
GLAD DANCE	DAD GLANCE
GLAD MOBILE	MAD GLOBAL
GLASS MOBILE	MASS GLOBAL
GRAB LAND	LAB GRAND
GRAB LATELY	LAB GREATLY
GRACE BAND	BASE GRAND
GRACE FOUND	FACE GROUND
GRACE PANT	PACE GRANT
GRACE POUND	PACE GROUND
GRACE ROUND	RACE GROUND
GRADE FOUND	FADE GROUND
GRAIN LAND	LANE GRAND
GRAIN LATELY	LANE GREATLY
GRAIN PANT	PAIN GRANT
GRAIN POUND	PAIN GROUND
GRAIN ROUND	RAIN GROUND
GRAND LATELY	LAND GREATLY
GRAND SOUND	SAND GROUND
GRANT POUND	PANT GROUND
GRAPH HAND	HALF GRAND
GRAPH LAND	LAUGH GRAND
GRAPH LATELY	LAUGH GREATLY
GRASS PANT	PASS GRANT
GRASS POUND	PASS GROUND
GRAVE SAND	SAVE GRAND
GRAVE SOUND	SAVE GROUND
GRAVE WOUND	WAVE GROUND
GREAT FOUND	FATE GROUND
GREAT HAND	HATE GRAND
GREAT LAND	LATE GRAND
GREAT LATELY	LATE GREATLY
GREAT ROUND	RATE GROUND
GREAT WOUND	WAIT GROUND
GREATLY LAND	LATELY GRAND
GREEK LAND	LEAK GRAND
GREEK LATELY	LEAK GREATLY
GREEK PANT	PEAK GRANT
GREEK POUND	PEAK GROUND
GREEK SAND	SEEK GRAND
GREEK SOUND	SEEK GROUND
GREEK WOUND	WEAK GROUND
GREEN BAND	BEAN GRAND
GREEN LAND	LEAN GRAND
GREEN LATELY	LEAN GREATLY
GREEN SAND	SCENE GRAND
GREEN SOUND	SCENE GROUND
GREET BAND	BEAT GRAND
GREET HAND	HEAT GRAND
GREET SAND	SEAT GRAND
GREET SOUND	SEAT GROUND
GREET WOUND	WHEAT GROUND
GRID BAND	BID GRAND
GRID ROUND	RID GROUND
GRIEF BAND	BEEF GRAND
GRIEF LAND	LEAF GRAND
GRIEF LATELY	LEAF GREATLY
GRIP HAND	HIP GRAND
GRIP LAND	LIP GRAND
GRIP LATELY	LIP GREATLY
GRIP ROUND	RIP GROUND
GRIP WOUND	WHIP GROUND
GROUND PANT	POUND GRANT
GROUND SAND	SOUND GRAND
GROUP LAND	LOOP GRAND
GROUP LATELY	LOOP GREATLY
GROUP SAND	SOUP GRAND
GROUP SOUND	SOUP GROUND
GROWTH BAND	BOTH GRAND
HIGHLY FLIGHT	FLEE HIGHLIGHT
HONEY ENTER	ANY HUNTER
HUNGER ANGRY	ANGER HUNGRY
HUNGRY ANGER	ANGRY HUNGER
HUNT ANGER	AUNT HUNGER
HUNT ANGRY	AUNT HUNGRY
IMPLY APPROVE	APPLY IMPROVE
IMPLY OPPOSE	APPLY IMPOSE
IMPOSE APPLY	OPPOSE IMPLY
IMPOSE APPROVE	OPPOSE IMPROVE
IMPROVE APPLY	APPROVE IMPLY
IMPROVE OPPOSE	APPROVE IMPOSE
INSERT ASIDE	ASSERT INSIDE
INSERT ASSIST	ASSERT INSIST
INSERT ATTEND	ASSERT INTEND
INSIDE ASSERT	ASIDE INSERT
INSIDE ASSIST	ASIDE INSIST
INSIDE ATTEND	ASIDE INTEND
INSIST ASIDE	ASSIST INSIDE
INSIST ASSERT	ASSIST INSERT
INSIST ATTEND	ASSIST INTEND
INTEND ASIDE	ATTEND INSIDE
INTEND ASSERT	ATTEND INSERT
INTEND ASSIST	ATTEND INSIST
IRISH FUNNY	FISH IRONY
LAND AFTER	AND LAUGHTER
LAND ENDING	END LANDING
LEAST EAGLE	EAST LEGAL
LEATHER EVIL	EITHER LEVEL
O'CLOCK COMPANY	CLOCK ACCOMPANY
O'CLOCK COUNT	CLOCK ACCOUNT
O'CLOCK CROSS	CLOCK ACROSS
OFFEND BOARD	BEND AFFORD
OFFEND LORD	LEND AFFORD
OFFEND SENSE	SEND OFFENSE
OFFEND SWORD	SEND AFFORD
OFFEND TENDER	TEND OFFENDER
OFFEND TRADE	TEND AFRAID
OFFENDER TEND	TENDER OFFEND
OFFENDER TRADE	TENDER AFRAID
OFFENSE SEND	SENSE OFFEND
OFFENSE SWORD	SENSE AFFORD
OPEN RUNNING	RUN OPENING
OPPOSE PARENT	POSE APPARENT
OPPOSE PART	POSE APART
OPPOSE POINT	POSE APPOINT
OPPOSE PROVE	POSE APPROVE
OUTLINE ASIDE	ALIGN OUTSIDE
OUTSIDE ALIGN	ASIDE OUTLINE
PART ARTICLE	ART PARTICLE
PERFECT ASSIST	AFFECT PERSIST
PERSIST AFFECT	ASSIST PERFECT
PERSIST EFFECT	ASSIST PERFECT
PLACE BASEMENT	BASE PLACEMENT
PLAIN MEASURE	MAIN PLEASURE
PLAN BASEMENT	BAN PLACEMENT
PLAN MEASURE	MAN PLEASURE
PLANE MEASURE	MAIN PLEASURE
PLATE MEASURE	MATE PLEASURE
PLAYER MEASURE	MAYOR PLEASURE
PLUS BASEMENT	BUS PLACEMENT
PRAISE REDUCE	RAISE PRODUCE
PRAISE REDUCTION	RAISE PRODUCTION
PRAISE REFER	RAISE PREFER
PRAISE REFERENCE	RAISE PREFERENCE
PRAISE REMOTE	RAISE PROMOTE
PRAISE RESERVE	RAISE PRESERVE
PRAISE RESIDENTIAL	RAISE PRESIDENTIAL
PRAYER BEAST	BARE PRIEST
PRAYER DESCRIPTION	DARE PRESCRIPTION
PRAYER DESERVE	DARE PRESERVE
PRAYER DETECT	DARE PROTECT
PRAYER DETECTIVE	DARE PROTECTIVE
PRAYER DOMINANT	DARE PROMINENT
PRAYER HINT	HAIR PRINT
PRAYER REDUCE	RARE PRODUCE
PRAYER REDUCTION	RARE PRODUCTION
PRAYER REFER	RARE PREFER
PRAYER REFERENCE	RARE PREFERENCE
PRAYER REMOTE	RARE PROMOTE
PRAYER RESERVE	RARE PRESERVE
PRAYER RESIDENTIAL	RARE PRESIDENTIAL
PREACH BEAST	BEACH PRIEST
PREACH REDUCE	REACH PRODUCE
PREACH REDUCTION	REACH PRODUCTION
PREACH REFER	REACH PREFER
PREACH REFERENCE	REACH PREFERENCE
PREACH REMOTE	REACH PROMOTE
PREACH RESERVE	REACH PRESERVE
PREACH RESIDENTIAL	REACH PRESIDENTIAL
PREFER CITY	SUFFER PRETTY
PREFER REDUCE	REFER PRODUCE
PREFER REDUCTION	REFER PRODUCTION
PREFER REFERENCE	REFER PREFERENCE
PREFER REMOTE	REFER PROMOTE
PREFER RESERVE	REFER PRESERVE
PREFER RESIDENTIAL	REFER PRESIDENTIAL
PREFER SEPARATION	SUFFER PREPARATION
PREFER SINCE	SUFFER PRINCE
PREFER SUPPOSE	SUFFER PROPOSE
PREFER SUPPOSED	SUFFER PROPOSED
PREFERENCE REDUCE	REFERENCE PRODUCE
PREFERENCE REDUCTION	REFERENCE PRODUCTION
PREFERENCE REFER	REFERENCE PREFER
PREFERENCE REMOTE	REFERENCE PROMOTE
PREFERENCE RESERVE	REFERENCE PRESERVE
PREFERENCE RESIDENTIAL	REFERENCE PRESIDENTIAL
PREPARATION CITY	SEPARATION PRETTY
PREPARATION SINCE	SEPARATION PRINCE
PREPARATION SUFFER	SEPARATION PREFER
PREPARATION SUPPOSE	SEPARATION PROPOSE
PREPARATION SUPPOSED	SEPARATION PROPOSED
PRESCRIPTION DESERVE	DESCRIPTION PRESERVE
PRESCRIPTION DETECT	DESCRIPTION PROTECT
PRESCRIPTION DETECTIVE	DESCRIPTION PROTECTIVE
PRESCRIPTION DOMINANT	DESCRIPTION PROMINENT
PRESERVE DESCRIPTION	DESERVE PRESCRIPTION
PRESERVE DETECT	DESERVE PROTECT
PRESERVE DETECTIVE	DESERVE PROTECTIVE
PRESERVE DOMINANT	DESERVE PROMINENT
PRESERVE REDUCE	RESERVE PRODUCE
PRESERVE REDUCTION	RESERVE PRODUCTION
PRESERVE REFER	RESERVE PREFER
PRESERVE REFERENCE	RESERVE PREFERENCE
PRESERVE REMOTE	RESERVE PROMOTE
PRESERVE RESIDENTIAL	RESERVE PRESIDENTIAL
PRESIDENTIAL REDUCE	RESIDENTIAL PRODUCE
PRESIDENTIAL REDUCTION	RESIDENTIAL PRODUCTION
PRESIDENTIAL REFER	RESIDENTIAL PREFER
PRESIDENTIAL REFERENCE	RESIDENTIAL PREFERENCE
PRESIDENTIAL REMOTE	RESIDENTIAL PROMOTE
PRESIDENTIAL RESERVE	RESIDENTIAL PRESERVE
PRESS LEAST	LESS PRIEST
PRETTY SEPARATION	CITY PREPARATION
PRETTY SINCE	CITY PRINCE
PRETTY SUFFER	CITY PREFER
PRETTY SUPPOSE	CITY PROPOSE
PRETTY SUPPOSED	CITY PROPOSED
PRICE REDUCE	RICE PRODUCE
PRICE REDUCTION	RICE PRODUCTION
PRICE REFER	RICE PREFER
PRICE REFERENCE	RICE PREFERENCE
PRICE REMOTE	RICE PROMOTE
PRICE RESERVE	RICE PRESERVE
PRICE RESIDENTIAL	RICE PRESIDENTIAL
PRIDE CITY	SIDE PRETTY
PRIDE HINT	HIDE PRINT
PRIDE REDUCE	RIDE PRODUCE
PRIDE REDUCTION	RIDE PRODUCTION
PRIDE REFER	RIDE PREFER
PRIDE REFERENCE	RIDE PREFERENCE
PRIDE REMOTE	RIDE PROMOTE
PRIDE RESERVE	RIDE PRESERVE
PRIDE RESIDENTIAL	RIDE PRESIDENTIAL
PRIDE SEPARATION	SIDE PREPARATION
PRIDE SINCE	SIDE PRINCE
PRIDE SUFFER	SIDE PREFER
PRIDE SUPPOSE	SIDE PROPOSE
PRIDE SUPPOSED	SIDE PROPOSED
PRINCE CITY	SINCE PRETTY
PRINCE SEPARATION	SINCE PREPARATION
PRINCE SUFFER	SINCE PREFER
PRINCE SUPPOSE	SINCE PROPOSE
PRINCE SUPPOSED	SINCE PROPOSED
PRIOR BEAST	BUYER PRIEST
PRIOR HINT	HIRE PRINT
PRIOR LEAST	LIAR PRIEST
PRIZE CITY	SIZE PRETTY
PRIZE REDUCE	RISE PRODUCE
PRIZE REDUCTION	RISE PRODUCTION
PRIZE REFER	RISE PREFER
PRIZE REFERENCE	RISE PREFERENCE
PRIZE REMOTE	RISE PROMOTE
PRIZE RESERVE	RISE PRESERVE
PRIZE RESIDENTIAL	RISE PRESIDENTIAL
PRIZE SEPARATION	SIZE PREPARATION
PRIZE SINCE	SIZE PRINCE
PRIZE SUFFER	SIZE PREFER
PRIZE SUPPOSE	SIZE PROPOSE
PRIZE SUPPOSED	SIZE PROPOSED
PRODUCE REDUCTION	REDUCE PRODUCTION
PRODUCE REFER	REDUCE PREFER
PRODUCE REFERENCE	REDUCE PREFERENCE
PRODUCE REMOTE	REDUCE PROMOTE
PRODUCE RESERVE	REDUCE PRESERVE
PRODUCE RESIDENTIAL	REDUCE PRESIDENTIAL
PRODUCTION REDUCE	REDUCTION PRODUCE
PRODUCTION REFER	REDUCTION PREFER
PRODUCTION REFERENCE	REDUCTION PREFERENCE
PRODUCTION REMOTE	REDUCTION PROMOTE
PRODUCTION RESERVE	REDUCTION PRESERVE
PRODUCTION RESIDENTIAL	REDUCTION PRESIDENTIAL
PROMINENT DESCRIPTION	DOMINANT PRESCRIPTION
PROMINENT DESERVE	DOMINANT PRESERVE
PROMINENT DETECT	DOMINANT PROTECT
PROMINENT DETECTIVE	DOMINANT PROTECTIVE
PROMOTE REDUCE	REMOTE PRODUCE
PROMOTE REDUCTION	REMOTE PRODUCTION
PROMOTE REFER	REMOTE PREFER
PROMOTE REFERENCE	REMOTE PREFERENCE
PROMOTE RESERVE	REMOTE PRESERVE
PROMOTE RESIDENTIAL	REMOTE PRESIDENTIAL
PROOF REDUCE	ROOF PRODUCE
PROOF REDUCTION	ROOF PRODUCTION
PROOF REFER	ROOF PREFER
PROOF REFERENCE	ROOF PREFERENCE
PROOF REMOTE	ROOF PROMOTE
PROOF RESERVE	ROOF PRESERVE
PROOF RESIDENTIAL	ROOF PRESIDENTIAL
PROPOSE CITY	SUPPOSE PRETTY
PROPOSE SEPARATION	SUPPOSE PREPARATION
PROPOSE SINCE	SUPPOSE PRINCE
PROPOSE SUFFER	SUPPOSE PREFER
PROPOSE SUPPOSED	SUPPOSE PROPOSED
PROPOSED CITY	SUPPOSED PRETTY
PROPOSED SEPARATION	SUPPOSED PREPARATION
PROPOSED SINCE	SUPPOSED PRINCE
PROPOSED SUFFER	SUPPOSED PREFER
PROPOSED SUPPOSE	SUPPOSED PROPOSE
PROTECT DESCRIPTION	DETECT PRESCRIPTION
PROTECT DESERVE	DETECT PRESERVE
PROTECT DETECTIVE	DETECT PROTECTIVE
PROTECT DOMINANT	DETECT PROMINENT
PROTECTIVE DESCRIPTION	DETECTIVE PRESCRIPTION
PROTECTIVE DESERVE	DETECTIVE PRESERVE
PROTECTIVE DETECT	DETECTIVE PROTECT
PROTECTIVE DOMINANT	DETECTIVE PROMINENT
PROUD LEAST	LOUD PRIEST
QUEEN BEST	BEAN QUEST
QUEEN TEST	TEEN QUEST
QUEST RIOT	REST QUIET
QUIET REST	RIOT QUEST
QUIT BEST	BIT QUEST
QUITE BEST	BITE QUEST
QUITE NEST	NIGHT QUEST
QUITE REST	RIGHT QUEST
QUITE RIOT	RIGHT QUIET
QUITE TEST	TIGHT QUEST
QUITE WEST	WHITE QUEST
QUOTE BEST	BOAT QUEST
QUOTE GUEST	GOAT QUEST
QUOTE NEST	NOTE QUEST
RECORDING APPLY	ACCORDING REPLY
RECORDING AWARD	ACCORDING REWARD
RELIEVE SPARE	SLEEVE REPAIR
RELY ASPECT	ALLY RESPECT
RENT AVENUE	AUNT REVENUE
REPAIR SLEEVE	SPARE RELIEVE
REPLY ACCORDING	APPLY RECORDING
REPLY AWARD	APPLY REWARD
REWARD ACCORDING	AWARD RECORDING
REWARD APPLY	AWARD REPLY
RIVAL EATING	EVIL WRITING
RUNNER OCEAN	OWNER RUSSIAN
SCALE MARRY	MAIL SCARY
SCALE MATTER	MAIL SCATTER
SCAN BURY	BAN SCARY
SCAN CANDLE	CAN SCANDAL
SCAN COLLAR	CAN SCHOLAR
SCAN CREAM	CAN SCREAM
SCAN MARRY	MAN SCARY
SCAN MATTER	MAN SCATTER
SCAN VARY	VAN SCARY
SCAN VERY	VAN SCARY
SCANDAL COLLAR	CANDLE SCHOLAR
SCANDAL CREAM	CANDLE SCREAM
SCARE BURY	BARE SCARY
SCARE CANDLE	CARE SCANDAL
SCARE COLLAR	CARE SCHOLAR
SCARE CREAM	CARE SCREAM
SCARE DOLLAR	DARE SCHOLAR
SCARE DREAM	DARE SCREAM
SCARE HANDLE	HAIR SCANDAL
SCARE SHARED	SHARE SCARED
SCARY MATTER	MARRY SCATTER
SCATTER MARRY	MATTER SCARY
SCHEME BURY	BEAM SCARY
SCHEME DOLLAR	DEEM SCHOLAR
SCHEME DREAM	DEEM SCREAM
SCHOLAR CANDLE	COLLAR SCANDAL
SCHOLAR CREAM	COLLAR SCREAM
SCHOLAR DREAM	DOLLAR SCREAM
SCHOOL CANDLE	COOL SCANDAL
SCHOOL COLLAR	COOL SCHOLAR
SCHOOL CREAM	COOL SCREAM
SCOPE CANDLE	COPE SCANDAL
SCOPE COLLAR	COPE SCHOLAR
SCOPE CREAM	COPE SCREAM
SCOPE HANDLE	HOPE SCANDAL
SCORE CANDLE	CORE SCANDAL
SCORE COLLAR	CORE SCHOLAR
SCORE CREAM	CORE SCREAM
SCORE DOLLAR	DOOR SCHOLAR
SCORE DREAM	DOOR SCREAM
SCORE MARRY	MORE SCARY
SCORE MATTER	MORE SCATTER
SCORE SHARED	SHORE SCARED
SCOUT DOLLAR	DOUBT SCHOLAR
SCOUT DREAM	DOUBT SCREAM
SCOUT SHARED	SHOUT SCARED
SCREAM CANDLE	CREAM SCANDAL
SCREAM COLLAR	CREAM SCHOLAR
SCREAM DOLLAR	DREAM SCHOLAR
SCREW CANDLE	CREW SCANDAL
SCREW COLLAR	CREW SCHOLAR
SCREW CREAM	CREW SCREAM
SECTION ACTOR	ACTION SECTOR
SECTION ANSWER	ACTION SENSOR
SECTOR ACTION	ACTOR SECTION
SECTOR ANSWER	ACTOR SENSOR
SELECT APPLY	ELECT SUPPLY
SELECT EFFICIENT	ELECT SUFFICIENT
SELECT ELECTION	ELECT SELECTION
SELECT OPPOSE	ELECT SUPPOSE
SELECT OPPOSED	ELECT SUPPOSED
SELECTION APPLY	ELECTION SUPPLY
SELECTION EFFICIENT	ELECTION SUFFICIENT
SELECTION ELECT	ELECTION SELECT
SELECTION OPPOSE	ELECTION SUPPOSE
SELECTION OPPOSED	ELECTION SUPPOSED
SEND ACTION	AND SECTION
SEND ACTOR	AND SECTOR
SEND ANSWER	AND SENSOR
SEND ENTER	END CENTER
SENSOR ACTION	ANSWER SECTION
SENSOR ACTOR	ANSWER SECTOR
SEPARATE OPERATION	OPERATE SEPARATION
SEPARATION OPERATE	OPERATION SEPARATE
SETTING EVEN	EATING SEVEN
SEVEN EATING	EVEN SETTING
SILLY ANGLE	ALLEY SINGLE
SILLY FREEZE	FLEE SERIES
SKILL BURY	BILL SCARY
SKILL CANDLE	KILL SCANDAL
SKILL COLLAR	KILL SCHOLAR
SKILL CREAM	KILL SCREAM
SKILL HANDLE	HILL SCANDAL
SKILL MARRY	MILL SCARY
SKILL MATTER	MILL SCATTER
SKIP HANDLE	HIP SCANDAL
SKIP LATTER	LIP SCATTER
SKIP SHARED	SHIP SCARED
SKIRT DOLLAR	DIRT SCHOLAR
SKIRT DREAM	DIRT SCREAM
SKIRT HANDLE	HURT SCANDAL
SKIRT SHARED	SHIRT SCARED
SLAP LIGHTLY	LAP SLIGHTLY
SLEEP LIGHTLY	LEAP SLIGHTLY
SLEEVE LIGHTLY	LEAVE SLIGHTLY
SLIDE HOLY	HIDE SLOWLY
SLIGHT HOLY	HEIGHT SLOWLY
SLIGHT LIGHTLY	LIGHT SLIGHTLY
SLIP HOLY	HIP SLOWLY
SLIP LIGHTLY	LIP SLIGHTLY
SLOPE HOLY	HOPE SLOWLY
SMALL CART	CALL SMART
SMALL HEART	HALL SMART
SMELL HEART	HELL SMART
SMILE PART	PILE SMART
SORRY FLOOD	FREE SOLID
SPACE BEND	BASE SPEND
SPACE BREAD	BASE SPREAD
SPACE BRING	BASE SPRING
SPACE COURT	CASE SPORT
SPACE PARK	PACE SPARK
SPACE PORT	PACE SPORT
SPARE BEND	BARE SPEND
SPARE BREAD	BARE SPREAD
SPARE BRING	BARE SPRING
SPARE COURT	CARE SPORT
SPARE DARK	DARE SPARK
SPARE PARK	PAIR SPARK
SPARE PORT	PAIR SPORT
SPARE SHARK	SHARE SPARK
SPARE SHORT	SHARE SPORT
SPARE TEND	TEAR SPEND
SPARK PORT	PARK SPORT
SPARK SHORT	SHARK SPORT
SPEAK LEND	LEAK SPEND
SPEAK PARK	PEAK SPARK
SPEAK PORT	PEAK SPORT
SPEECH BEND	BEACH SPEND
SPEECH BREAD	BEACH SPREAD
SPEECH BRING	BEACH SPRING
SPEECH TEND	TEACH SPEND
SPELL BEND	BELL SPEND
SPELL BREAD	BELL SPREAD
SPELL BRING	BELL SPRING
SPELL SHARK	SHELL SPARK
SPELL SHORT	SHELL SPORT
SPELL TEND	TELL SPEND
SPEND BREAD	BEND SPREAD
SPEND BRING	BEND SPRING
SPILL BEND	BILL SPEND
SPILL BREAD	BILL SPREAD
SPILL BRING	BILL SPRING
SPILL COURT	KILL SPORT
SPILL MARK	MILL SPARK
SPILL PARK	PILL SPARK
SPILL PORT	PILL SPORT
SPILL TEND	TILL SPEND
SPIN PARK	PIN SPARK
SPIN PORT	PIN SPORT
SPIN THREAD	THIN SPREAD
SPIT BEND	BIT SPEND
SPIT BREAD	BIT SPREAD
SPIT BRING	BIT SPRING
SPIT COURT	KIT SPORT
SPIT PARK	PIT SPARK
SPIT PORT	PIT SPORT
SPITE BEND	BITE SPEND
SPITE BREAD	BITE SPREAD
SPITE BRING	BITE SPRING
SPITE LEND	LIGHT SPEND
SPITE MARK	MIGHT SPARK
SPITE TEND	TIGHT SPEND
SPORT PARK	PORT SPARK
SPORT SHARK	SHORT SPARK
SPOT DARK	DOT SPARK
SPOT LEND	LOT SPEND
SPOT PARK	POT SPARK
SPOT PORT	POT SPORT
SPOT SHARK	SHOT SPARK
SPOT SHORT	SHOT SPORT
SPOUSE MARK	MOUSE SPARK
SPREAD BEND	BREAD SPEND
SPREAD BRING	BREAD SPRING
SPRING BEND	BRING SPEND
SPRING BREAD	BRING SPREAD
STABLE CAMP	CABLE STAMP
STABLE CART	CABLE START
STABLE CREAM	CABLE STREAM
STABLE CREEK	CABLE STREAK
STABLE LAMP	LABEL STAMP
STABLE LAND	LABEL STAND
STABLE LANDING	LABEL STANDING
STABLE TRAIN	TABLE STRAIN
STABLE TRAIT	TABLE STRAIGHT
STABLE TREAT	TABLE STREET
STABLE TRIP	TABLE STRIP
STACK BAND	BACK STAND
STACK BRAIN	BACK STRAIN
STACK BRING	BACK STRING
STACK BUDDY	BACK STUDY
STACK LABEL	LACK STABLE
STACK LAMP	LACK STAMP
STACK LAND	LACK STAND
STACK LANDING	LACK STANDING
STACK PART	PACK START
STACK PRESS	PACK STRESS
STACK READY	RACK STEADY
STACK RUNNING	RACK STUNNING
STAFF HAND	HALF STAND
STAFF HEART	HALF START
STAFF LABEL	LAUGH STABLE
STAFF LAMP	LAUGH STAMP
STAFF LAND	LAUGH STAND
STAFF LANDING	LAUGH STANDING
STAGE CABLE	CAGE STABLE
STAGE CAMP	CAGE STAMP
STAGE CART	CAGE START
STAGE CREAM	CAGE STREAM
STAGE CREEK	CAGE STREAK
STAGE PART	PAGE START
STAGE PRESS	PAGE STRESS
STAGE READY	RAGE STEADY
STAGE RUNNING	RAGE STUNNING
STAGE WARM	WAGE STORM
STAIR BAND	BARE STAND
STAIR BRAIN	BARE STRAIN
STAIR BRING	BARE STRING
STAIR BUDDY	BARE STUDY
STAIR CABLE	CARE STABLE
STAIR CAMP	CARE STAMP
STAIR CART	CARE START
STAIR CHANCE	CHAIR STANCE
STAIR CHART	CHAIR START
STAIR CHARTER	CHAIR STARTER
STAIR CREAM	CARE STREAM
STAIR CREEK	CARE STREAK
STAIR DANCE	DARE STANCE
STAIR DRAIN	DARE STRAIN
STAIR DREAM	DARE STREAM
STAIR DRESS	DARE STRESS
STAIR DRIVE	DARE STRIVE
STAIR FORM	FAIR STORM
STAIR FREAK	FAIR STREAK
STAIR HAND	HAIR STAND
STAIR HEART	HAIR START
STAIR PART	PAIR START
STAIR PRESS	PAIR STRESS
STAIR READY	RARE STEADY
STAIR RUNNING	RARE STUNNING
STAIR TABLE	TEAR STABLE
STAIR TRAIN	TEAR STRAIN
STAIR TRAIT	TEAR STRAIGHT
STAIR TREAT	TEAR STREET
STAIR TRIP	TEAR STRIP
STAIR WARM	WEAR STORM
STAKE BAND	BAKE STAND
STAKE BRAIN	BAKE STRAIN
STAKE BRING	BAKE STRING
STAKE BUDDY	BAKE STUDY
STAKE CABLE	CAKE STABLE
STAKE CAMP	CAKE STAMP
STAKE CART	CAKE START
STAKE CREAM	CAKE STREAM
STAKE CREEK	CAKE STREAK
STAKE FORM	FAKE STORM
STAKE FREAK	FAKE STREAK
STAKE LABEL	LAKE STABLE
STAKE LAMP	LAKE STAMP
STAKE LAND	LAKE STAND
STAKE LANDING	LAKE STANDING
STAKE TABLE	TAKE STABLE
STAKE TRAIN	TAKE STRAIN
STAKE TRAIT	TAKE STRAIGHT
STAKE TREAT	TAKE STREET
STAKE TRIP	TAKE STRIP
STAKE WARM	WAKE STORM
STAMP CABLE	CAMP STABLE
STAMP CART	CAMP START
STAMP CREAM	CAMP STREAM
STAMP CREEK	CAMP STREAK
STAMP LABEL	LAMP STABLE
STAMP LAND	LAMP STAND
STAMP LANDING	LAMP STANDING
STANCE CHART	CHANCE START
STANCE CHARTER	CHANCE STARTER
STANCE DRAIN	DANCE STRAIN
STANCE DREAM	DANCE STREAM
STANCE DRESS	DANCE STRESS
STANCE DRIVE	DANCE STRIVE
STAND BRAIN	BAND STRAIN
STAND BRING	BAND STRING
STAND BUDDY	BAND STUDY
STAND HEART	HAND START
STAND LABEL	LAND STABLE
STAND LAMP	LAND STAMP
STAND LANDING	LAND STANDING
STANDING LABEL	LANDING STABLE
STANDING LAMP	LANDING STAMP
STANDING LAND	LANDING STAND
STAR BAND	BAR STAND
STAR BRAIN	BAR STRAIN
STAR BRING	BAR STRING
STAR BUDDY	BAR STUDY
STAR CABLE	CAR STABLE
STAR CAMP	CAR STAMP
STAR CART	CAR START
STAR CREAM	CAR STREAM
STAR CREEK	CAR STREAK
STAR FORM	FAR STORM
STAR FREAK	FAR STREAK
STARE BAND	BARE STAND
STARE BRAIN	BARE STRAIN
STARE BRING	BARE STRING
STARE BUDDY	BARE STUDY
STARE CABLE	CARE STABLE
STARE CAMP	CARE STAMP
STARE CART	CARE START
STARE CHANCE	CHAIR STANCE
STARE CHART	CHAIR START
STARE CHARTER	CHAIR STARTER
STARE CREAM	CARE STREAM
STARE CREEK	CARE STREAK
STARE DANCE	DARE STANCE
STARE DRAIN	DARE STRAIN
STARE DREAM	DARE STREAM
STARE DRESS	DARE STRESS
STARE DRIVE	DARE STRIVE
STARE FORM	FAIR STORM
STARE FREAK	FAIR STREAK
STARE HAND	HAIR STAND
STARE HEART	HAIR START
STARE PART	PAIR START
STARE PRESS	PAIR STRESS
STARE READY	RARE STEADY
STARE RUNNING	RARE STUNNING
STARE TABLE	TEAR STABLE
STARE TRAIN	TEAR STRAIN
STARE TRAIT	TEAR STRAIGHT
STARE TREAT	TEAR STREET
STARE TRIP	TEAR STRIP
STARE WARM	WEAR STORM
START CABLE	CART STABLE
START CAMP	CART STAMP
START CHANCE	CHART STANCE
START CHARTER	CHART STARTER
START CREAM	CART STREAM
START CREEK	CART STREAK
START HAND	HEART STAND
START PRESS	PART STRESS
STARTER CHANCE	CHARTER STANCE
STARTER CHART	CHARTER START
STATE DANCE	DATE STANCE
STATE DRAIN	DATE STRAIN
STATE DREAM	DATE STREAM
STATE DRESS	DATE STRESS
STATE DRIVE	DATE STRIVE
STATE FORM	FATE STORM
STATE FREAK	FATE STREAK
STATE GRAIN	GATE STRAIN
STATE GREAT	GATE STRAIGHT
STATE GREEK	GATE STREAK
STATE GREET	GATE STREET
STATE GRIP	GATE STRIP
STATE HAND	HATE STAND
STATE HEART	HATE START
STATE LABEL	LATE STABLE
STATE LAMP	LATE STAMP
STATE LAND	LATE STAND
STATE LANDING	LATE STANDING
STATE READY	RATE STEADY
STATE RUNNING	RATE STUNNING
STATE WARM	WAIT STORM
STATION NORM	NATION STORM
STEADY RUNNING	READY STUNNING
STEAK BAND	BAKE STAND
STEAK BRAIN	BAKE STRAIN
STEAK BRING	BAKE STRING
STEAK BUDDY	BAKE STUDY
STEAK CABLE	CAKE STABLE
STEAK CAMP	CAKE STAMP
STEAK CART	CAKE START
STEAK CREAM	CAKE STREAM
STEAK CREEK	CAKE STREAK
STEAK FORM	FAKE STORM
STEAK FREAK	FAKE STREAK
STEAK LABEL	LAKE STABLE
STEAK LAMP	LAKE STAMP
STEAK LAND	LAKE STAND
STEAK LANDING	LAKE STANDING
STEAK TABLE	TAKE STABLE
STEAK TRAIN	TAKE STRAIN
STEAK TRAIT	TAKE STRAIGHT
STEAK TREAT	TAKE STREET
STEAK TRIP	TAKE STRIP
STEAK WARM	WAKE STORM
STEAL DANCE	DEAL STANCE
STEAL DRAIN	DEAL STRAIN
STEAL DREAM	DEAL STREAM
STEAL DRESS	DEAL STRESS
STEAL DRIVE	DEAL STRIVE
STEAL FORM	FEEL STORM
STEAL FREAK	FEEL STREAK
STEAL HAND	HEAL STAND
STEAL HEART	HEAL START
STEAL PART	PEEL START
STEAL PRESS	PEEL STRESS
STEAL READY	REAL STEADY
STEAL RUNNING	REAL STUNNING
STEAL WARM	WHEEL STORM
STEAM BAND	BEAM STAND
STEAM BRAIN	BEAM STRAIN
STEAM BRING	BEAM STRING
STEAM BUDDY	BEAM STUDY
STEAM DANCE	DEEM STANCE
STEAM DRAIN	DEEM STRAIN
STEAM DREAM	DEEM STREAM
STEAM DRESS	DEEM STRESS
STEAM DRIVE	DEEM STRIVE
STEAM TABLE	TEAM STABLE
STEAM THRIVE	THEME STRIVE
STEAM TRAIN	TEAM STRAIN
STEAM TRAIT	TEAM STRAIGHT
STEAM TREAT	TEAM STREET
STEAM TRIP	TEAM STRIP
STEEL DANCE	DEAL STANCE
STEEL DRAIN	DEAL STRAIN
STEEL DREAM	DEAL STREAM
STEEL DRESS	DEAL STRESS
STEEL DRIVE	DEAL STRIVE
STEEL FORM	FEEL STORM
STEEL FREAK	FEEL STREAK
STEEL HAND	HEAL STAND
STEEL HEART	HEAL START
STEEL PART	PEEL START
STEEL PRESS	PEEL STRESS
STEEL READY	REAL STEADY
STEEL RUNNING	REAL STUNNING
STEEL WARM	WHEEL STORM
STEEP CABLE	KEEP STABLE
STEEP CAMP	KEEP STAMP
STEEP CART	KEEP START
STEEP CHANCE	CHEAP STANCE
STEEP CHART	CHEAP START
STEEP CHARTER	CHEAP STARTER
STEEP CREAM	KEEP STREAM
STEEP CREEK	KEEP STREAK
STEEP DANCE	DEEP STANCE
STEEP DRAIN	DEEP STRAIN
STEEP DREAM	DEEP STREAM
STEEP DRESS	DEEP STRESS
STEEP DRIVE	DEEP STRIVE
STEEP LABEL	LEAP STABLE
STEEP LAMP	LEAP STAMP
STEEP LAND	LEAP STAND
STEEP LANDING	LEAP STANDING
STEP READY	REP STEADY
STEP RUNNING	REP STUNNING
STICK CABLE	KICK STABLE
STICK CAMP	KICK STAMP
STICK CART	KICK START
STICK CREAM	KICK STREAM
STICK CREEK	KICK STREAK
STICK PART	PICK START
STICK PRESS	PICK STRESS
STICK THRIVE	THICK STRIVE
STILL BAND	BILL STAND
STILL BRAIN	BILL STRAIN
STILL BRING	BILL STRING
STILL BUDDY	BILL STUDY
STILL CABLE	KILL STABLE
STILL CAMP	KILL STAMP
STILL CART	KILL START
STILL CREAM	KILL STREAM
STILL CREEK	KILL STREAK
STILL FORM	FILL STORM
STILL FREAK	FILL STREAK
STILL HAND	HILL STAND
STILL HEART	HILL START
STILL PART	PILL START
STILL PRESS	PILL STRESS
STILL TABLE	TILL STABLE
STILL TRAIN	TILL STRAIN
STILL TRAIT	TILL STRAIGHT
STILL TREAT	TILL STREET
STILL TRIP	TILL STRIP
STILL WARM	WILL STORM
STOCK DANCE	DOC STANCE
STOCK DRAIN	DOC STRAIN
STOCK DREAM	DOC STREAM
STOCK DRESS	DOC STRESS
STOCK DRIVE	DOC STRIVE
STOCK LABEL	LOCK STABLE
STOCK LAMP	LOCK STAMP
STOCK LAND	LOCK STAND
STOCK LANDING	LOCK STANDING
STOCK NATION	KNOCK STATION
STOCK NORM	KNOCK STORM
STOCK READY	ROCK STEADY
STOCK RUNNING	ROCK STUNNING
STOCK WARM	WALK STORM
STONE BAND	BONE STAND
STONE BRAIN	BONE STRAIN
STONE BRING	BONE STRING
STONE BUDDY	BONE STUDY
STONE FORM	PHONE STORM
STONE FREAK	PHONE STREAK
STONE LABEL	LOAN STABLE
STONE LAMP	LOAN STAMP
STONE LAND	LOAN STAND
STONE LANDING	LOAN STANDING
STONE NATION	KNOWN STATION
STONE NORM	KNOWN STORM
STONE TABLE	TONE STABLE
STONE TRAIN	TONE STRAIN
STONE TRAIT	TONE STRAIGHT
STONE TREAT	TONE STREET
STONE TRIP	TONE STRIP
STOP CABLE	COP STABLE
STOP CAMP	COP STAMP
STOP CART	COP START
STOP CHANCE	CHOP STANCE
STOP CHART	CHOP START
STOP CHARTER	CHOP STARTER
STOP CREAM	COP STREAM
STOP CREEK	COP STREAK
STOP PART	POP START
STOP PRESS	POP STRESS
STOP TABLE	TOP STABLE
STOP TRAIN	TOP STRAIN
STOP TRAIT	TOP STRAIGHT
STOP TREAT	TOP STREET
STOP TRIP	TOP STRIP
STORE CABLE	CORE STABLE
STORE CAMP	CORE STAMP
STORE CART	CORE START
STORE CREAM	CORE STREAM
STORE CREEK	CORE STREAK
STORE DANCE	DOOR STANCE
STORE DRAIN	DOOR STRAIN
STORE DREAM	DOOR STREAM
STORE DRESS	DOOR STRESS
STORE DRIVE	DOOR STRIVE
STORE FORM	FOR STORM
STORE FREAK	FOR STREAK
STORE NATION	NOR STATION
STORE NORM	NOR STORM
STORE PART	POUR START
STORE PRESS	POUR STRESS
STORE WARM	WAR STORM
STORM FREAK	FORM STREAK
STORM NATION	NORM STATION
STRAIGHT GRAIN	GREAT STRAIN
STRAIGHT GREEK	GREAT STREAK
STRAIGHT GREET	GREAT STREET
STRAIGHT GRIP	GREAT STRIP
STRAIGHT TABLE	TRAIT STABLE
STRAIGHT TRAIN	TRAIT STRAIN
STRAIGHT TREAT	TRAIT STREET
STRAIGHT TRIP	TRAIT STRIP
STRAIN BAND	BRAIN STAND
STRAIN BRING	BRAIN STRING
STRAIN BUDDY	BRAIN STUDY
STRAIN DANCE	DRAIN STANCE
STRAIN DREAM	DRAIN STREAM
STRAIN DRESS	DRAIN STRESS
STRAIN DRIVE	DRAIN STRIVE
STRAIN GREAT	GRAIN STRAIGHT
STRAIN GREEK	GRAIN STREAK
STRAIN GREET	GRAIN STREET
STRAIN GRIP	GRAIN STRIP
STRAIN TABLE	TRAIN STABLE
STRAIN TRAIT	TRAIN STRAIGHT
STRAIN TREAT	TRAIN STREET
STRAIN TRIP	TRAIN STRIP
STREAK CABLE	CREEK STABLE
STREAK CAMP	CREEK STAMP
STREAK CART	CREEK START
STREAK CREAM	CREEK STREAM
STREAK FORM	FREAK STORM
STREAK GRAIN	GREEK STRAIN
STREAK GREAT	GREEK STRAIGHT
STREAK GREET	GREEK STREET
STREAK GRIP	GREEK STRIP
STREAM CABLE	CREAM STABLE
STREAM CAMP	CREAM STAMP
STREAM CART	CREAM START
STREAM CREEK	CREAM STREAK
STREAM DANCE	DREAM STANCE
STREAM DRAIN	DREAM STRAIN
STREAM DRESS	DREAM STRESS
STREAM DRIVE	DREAM STRIVE
STREET GRAIN	GREET STRAIN
STREET GREAT	GREET STRAIGHT
STREET GREEK	GREET STREAK
STREET GRIP	GREET STRIP
STREET TABLE	TREAT STABLE
STREET TRAIN	TREAT STRAIN
STREET TRAIT	TREAT STRAIGHT
STREET TRIP	TREAT STRIP
STRESS DANCE	DRESS STANCE
STRESS DRAIN	DRESS STRAIN
STRESS DREAM	DRESS STREAM
STRESS DRIVE	DRESS STRIVE
STRESS PART	PRESS START
STRING BAND	BRING STAND
STRING BRAIN	BRING STRAIN
STRING BUDDY	BRING STUDY
STRIP GRAIN	GRIP STRAIN
STRIP GREAT	GRIP STRAIGHT
STRIP GREEK	GRIP STREAK
STRIP GREET	GRIP STREET
STRIP TABLE	TRIP STABLE
STRIP TRAIN	TRIP STRAIN
STRIP TRAIT	TRIP STRAIGHT
STRIP TREAT	TRIP STREET
STRIVE DANCE	DRIVE STANCE
STRIVE DRAIN	DRIVE STRAIN
STRIVE DREAM	DRIVE STREAM
STRIVE DRESS	DRIVE STRESS
STUDY BAND	BUDDY STAND
STUDY BRAIN	BUDDY STRAIN
STUDY BRING	BUDDY STRING
STUFF READY	ROUGH STEADY
STUFF RUNNING	ROUGH STUNNING
STUFF TABLE	TOUGH STABLE
STUFF TRAIN	TOUGH STRAIN
STUFF TRAIT	TOUGH STRAIGHT
STUFF TREAT	TOUGH STREET
STUFF TRIP	TOUGH STRIP
STUNNING READY	RUNNING STEADY
STYLE FORM	FILE STORM
STYLE FREAK	FILE STREAK
STYLE PART	PILE START
STYLE PRESS	PILE STRESS
STYLE WARM	WHILE STORM
SUCCESS ASPECT	ACCESS SUSPECT
SUFFER OFFERING	OFFER SUFFERING
SUFFICIENT APPLY	EFFICIENT SUPPLY
SUFFICIENT ELECT	EFFICIENT SELECT
SUFFICIENT ELECTION	EFFICIENT SELECTION
SUFFICIENT OPPOSE	EFFICIENT SUPPOSE
SUFFICIENT OPPOSED	EFFICIENT SUPPOSED
SUPPLY EFFICIENT	APPLY SUFFICIENT
SUPPLY ELECT	APPLY SELECT
SUPPLY ELECTION	APPLY SELECTION
SUPPLY OPPOSE	APPLY SUPPOSE
SUPPLY OPPOSED	APPLY SUPPOSED
SUPPOSE APPLY	OPPOSE SUPPLY
SUPPOSE EFFICIENT	OPPOSE SUFFICIENT
SUPPOSE ELECT	OPPOSE SELECT
SUPPOSE ELECTION	OPPOSE SELECTION
SUPPOSE OPPOSED	OPPOSE SUPPOSED
SUPPOSED APPLY	OPPOSED SUPPLY
SUPPOSED EFFICIENT	OPPOSED SUFFICIENT
SUPPOSED ELECT	OPPOSED SELECT
SUPPOSED ELECTION	OPPOSED SELECTION
SUPPOSED OPPOSE	OPPOSED SUPPOSE
SUSPECT ACCESS	ASPECT SUCCESS
SWEAR FOLLOW	FAIR SWALLOW
TRACE BEND	BASE TREND
TRACE BIBLE	BASE TRIBAL
TRACE BILLION	BASE TRILLION
TRACE BUBBLE	BASE TROUBLE
TRACE CHUNK	CHASE TRUNK
TRACK BEND	BACK TREND
TRACK BIBLE	BACK TRIBAL
TRACK BILLION	BACK TRILLION
TRACK BUBBLE	BACK TROUBLE
TRACK LEND	LACK TREND
TRACK SEND	SACK TREND
TRAGIC MEASURE	MAGIC TREASURE
TRAGIC MILLION	MAGIC TRILLION
TRAGIC MUST	MAGIC TRUST
TRAIL JUNK	JAIL TRUNK
TRAIL JUST	JAIL TRUST
TRAIL MAGIC	MAIL TRAGIC
TRAIL MEASURE	MAIL TREASURE
TRAIL MILLION	MAIL TRILLION
TRAIL MUST	MAIL TRUST
TRAIL NEWLY	NAIL TRULY
TRAIL SEND	SAIL TREND
TRAIN CHUNK	CHAIN TRUNK
TRAIN LEND	LANE TREND
TRAIN MAGIC	MAIN TRAGIC
TRAIN MEASURE	MAI