ACTION MOTIVE	MOTION ACTIVE
ACTION MOTOR	MOTION ACTOR
ACTION NATIVE	NATION ACTIVE
ACTIVE MOTION	MOTIVE ACTION
ACTIVE MOTOR	MOTIVE ACTOR
ACTIVE NATION	NATIVE ACTION
ACTOR MOTION	MOTOR ACTION
ACTOR MOTIVE	MOTOR ACTIVE
AFFAIR SPEND	SPARE OFFEND
AGENCY CURRENT	CURRENCY AGENT
AGENT CURRENCY	CURRENT AGENCY
AGREE BELLY	BURY UGLY
ALIVE DIRECT	DERIVE ELECT
ALIVE DIRECTION	DERIVE ELECTION
ALIVE THRONE	THRIVE ALONE
ALONE THRIVE	THRONE ALIVE
APART STEAL	START APPEAL
APART STEEL	START APPEAL
APPEAL START	STEAL APART
APPEAR CLOSED	CLEAR OPPOSED
ASIDE PRESS	PRIDE ASSESS
ASSESS PRIDE	PRESS ASIDE
ATTACK BLEND	BLACK ATTEND
ATTACK TREND	TRACK ATTEND
ATTEND BLACK	BLEND ATTACK
ATTEND TRACK	TREND ATTACK
AUTOMATIC DRAMATICALLY	DRAMATIC AUTOMATICALLY
AUTOMATICALLY DRAMATIC	DRAMATICALLY AUTOMATIC
AWAIT STAIR	STATE AWARE
AWAIT STAKE	STATE AWAKE
AWAIT STARE	STATE AWARE
AWAIT STEAK	STATE AWAKE
AWAKE STAIR	STAKE AWARE
AWAKE STARE	STAKE AWARE
AWAKE STATE	STAKE AWAIT
AWARE STAKE	STAIR AWAKE
AWARE STATE	STAIR AWAIT
AWARE STEAK	STAIR AWAKE
BACKUP PINK	PICKUP BANK
BADLY WIND	WIDELY BAND
BAND SETTLE	SEND BATTLE
BAND WIDELY	WIND BADLY
BANK LITTLE	LINK BATTLE
BANK PICKUP	PINK BACKUP
BATTLE LINK	LITTLE BANK
BATTLE SEND	SETTLE BAND
BELLY AGREE	UGLY BURY
BELLY HOST	HOLY BEST
BELLY RANCH	RALLY BENCH
BELLY VAST	VALLEY BEST
BELLY WRIST	REALLY BEST
BENCH LOST	LAUNCH BEST
BENCH RALLY	RANCH BELLY
BEND FIGHTER	FIND BETTER
BEND LAST	LAND BEST
BEND LATTER	LAND BETTER
BEST CARRY	CAST BURY
BEST HOLY	HOST BELLY
BEST LAND	LAST BEND
BEST LATTER	LAST BETTER
BEST LAUNCH	LOST BENCH
BEST MOTOR	MOST BETTER
BEST REALLY	WRIST BELLY
BEST VALLEY	VAST BELLY
BETTER FIND	FIGHTER BEND
BETTER LAND	LATTER BEND
BETTER LAST	LATTER BEST
BETTER MOST	MOTOR BEST
CANCER SETTLE	SENSOR CATTLE
CANDY MUSCLE	MONDAY CASTLE
CANDY MUST	MONDAY CAST
CARD LOST	LORD COST
CARD SORT	SWORD CART
CARRY BEST	BURY CAST
CARRY METAL	MARRY CATTLE
CARRY VESSEL	VARY CASTLE
CART SWORD	SORT CARD
CAST BURY	BEST CARRY
CAST DUMP	DUST CAMP
CAST JUMP	JUST CAMP
CAST LITTLE	LIST CATTLE
CAST MONDAY	MUST CANDY
CAST MUSCLE	MUST CASTLE
CASTLE MONDAY	MUSCLE CANDY
CASTLE MUST	MUSCLE CAST
CASTLE VARY	VESSEL CARRY
CASTLE VERY	VESSEL CARRY
CATTLE LIST	LITTLE CAST
CATTLE MARRY	METAL CARRY
CATTLE SENSOR	SETTLE CANCER
CENT COUNTER	COUNT CENTER
CENT HUNTER	HUNT CENTER
CENT PAINTER	PAINT CENTER
CENT PASSION	PANT SESSION
CENTER COUNT	COUNTER CENT
CENTER HUNT	HUNTER CENT
CENTER PAINT	PAINTER CENT
CERTAIN BUCKET	BUTTON CIRCUIT
CERTAIN RIVER	WRITTEN SERVER
CHUCKLE TANK	TACKLE CHUNK
CHUNK TACKLE	TANK CHUCKLE
CIRCUIT BUTTON	BUCKET CERTAIN
CLASS GREEN	GRASS CLEAN
CLASS GRIP	GRASS CLIP
CLASS GROSS	GRASS CLOSE
CLEAN GRASS	GREEN CLASS
CLEAN GRIP	GREEN CLIP
CLEAN GROSS	GREEN CLOSE
CLEAR OPPOSED	APPEAR CLOSED
CLICK STIFF	STICK CLIFF
CLICK STOCK	STICK CLOCK
CLICK TRIP	TRICK CLIP
CLIFF STICK	STIFF CLICK
CLIFF STOCK	STIFF CLOCK
CLIMB PROUD	PRIME CLOUD
CLIP GRASS	GRIP CLASS
CLIP GREEN	GRIP CLEAN
CLIP GROSS	GRIP CLOSE
CLIP TRICK	TRIP CLICK
CLOCK STICK	STOCK CLICK
CLOCK STIFF	STOCK CLIFF
CLOSE GRASS	GROSS CLASS
CLOSE GREEN	GROSS CLEAN
CLOSE GRIP	GROSS CLIP
CLOSED APPEAR	OPPOSED CLEAR
CLOUD PRIME	PROUD CLIMB
COLLAR DEMON	DEALER COMMON
COMMISSION PERMIT	PERMISSION COMMIT
COMMISSION PURPLE	PERMISSION COUPLE
COMMIT PERMISSION	PERMIT COMMISSION
COMMIT PURPLE	PERMIT COUPLE
COMMON DEALER	DEMON COLLAR
CORD HEART	HARD COURT
CORRECT ELECTION	ELECT CORRECTION
CORRECTION ELECT	ELECTION CORRECT
COST LATIN	LAST COTTON
COST LORD	LOST CARD
COST WRITTEN	WRIST COTTON
COTTON LAST	LATIN COST
COTTON WRIST	WRITTEN COST
COUNT CENTER	CENT COUNTER
COUNT HUNTER	HUNT COUNTER
COUNT PAINTER	PAINT COUNTER
COUNTER CENT	CENTER COUNT
COUNTER HUNT	HUNTER COUNT
COUNTER PAINT	PAINTER COUNT
COUPLE PERMISSION	PURPLE COMMISSION
COUPLE PERMIT	PURPLE COMMIT
COURT HARD	HEART CORD
CRACK STEAM	STACK CREAM
CRACK STOP	STACK CROP
CRAP SNEAK	SNAP CREEK
CREAM STACK	STEAM CRACK
CREAM STOP	STEAM CROP
CREEK SNAP	SNEAK CRAP
CROP STACK	STOP CRACK
CROP STEAM	STOP CREAM
CURRENCY AGENT	AGENCY CURRENT
CURRENT AGENCY	AGENT CURRENCY
CYCLE TALENT	TACKLE SILENT
DANCE SENSOR	SENSE DANCER
DANCER SENSE	SENSOR DANCE
DEALER COMMON	COLLAR DEMON
DECIDE INSTRUCTION	INSIDE DESTRUCTION
DECREASE INSTANCE	INCREASE DISTANCE
DECREASE INSTANT	INCREASE DISTANT
DECREASE INSTINCT	INCREASE DISTINCT
DEMON COLLAR	COMMON DEALER
DERIVE ELECT	ALIVE DIRECT
DERIVE ELECTION	ALIVE DIRECTION
DESTRUCTION INSIDE	INSTRUCTION DECIDE
DETAIL REASON	RETAIL DOZEN
DIFFER RUNNER	REFER DINNER
DINNER MASK	MANNER DISK
DINNER REFER	RUNNER DIFFER
DIRECT ALIVE	ELECT DERIVE
DIRECT ELECTION	ELECT DIRECTION
DIRECTION ALIVE	ELECTION DERIVE
DIRECTION ELECT	ELECTION DIRECT
DISK MANNER	MASK DINNER
DISTANCE INCREASE	INSTANCE DECREASE
DISTANCE INSTANT	INSTANCE DISTANT
DISTANCE INSTINCT	INSTANCE DISTINCT
DISTANT INCREASE	INSTANT DECREASE
DISTANT INSTANCE	INSTANT DISTANCE
DISTANT INSTINCT	INSTANT DISTINCT
DISTINCT INCREASE	INSTINCT DECREASE
DISTINCT INSTANCE	INSTINCT DISTANCE
DISTINCT INSTANT	INSTINCT DISTANT
DOMAIN RUNNER	REMAIN DONOR
DONOR REMAIN	RUNNER DOMAIN
DOUBLE MOST	MOBILE DUST
DOUBLE REST	REBEL DUST
DOUBLE TASTE	TABLE DUST
DOZEN RETAIL	REASON DETAIL
DRAG FLOOR	FLAG DRAWER
DRAMATIC AUTOMATICALLY	AUTOMATIC DRAMATICALLY
DRAMATICALLY AUTOMATIC	AUTOMATICALLY DRAMATIC
DRAWER FLAG	FLOOR DRAG
DRAWER SCHEME	SCORE DREAM
DRAWER SKILL	SCORE DRILL
DRAWER STEAM	STORE DREAM
DRAWER STILL	STORE DRILL
DRAWER STOP	STORE DROP
DREAM SCORE	SCHEME DRAWER
DREAM SKILL	SCHEME DRILL
DREAM STILL	STEAM DRILL
DREAM STOP	STEAM DROP
DREAM STORE	STEAM DRAWER
DRILL SCHEME	SKILL DREAM
DRILL SCORE	SKILL DRAWER
DRILL STEAM	STILL DREAM
DRILL STOP	STILL DROP
DRILL STORE	STILL DRAWER
DROP STEAM	STOP DREAM
DROP STILL	STOP DRILL
DROP STORE	STOP DRAWER
DUMP CAST	CAMP DUST
DUMP LAST	LAMP DUST
DUST CAMP	CAST DUMP
DUST LAMP	LAST DUMP
DUST MOBILE	MOST DOUBLE
DUST REBEL	REST DOUBLE
DUST TABLE	TASTE DOUBLE
EDITION EMISSION	EMISSION ADDITION
EFFECT CORRECT	CORRECT AFFECT
EFFECT DIRECT	DIRECT AFFECT
ELECT CORRECTION	CORRECT ELECTION
ELECT DERIVE	DIRECT ALIVE
ELECT DIRECTION	DIRECT ELECTION
ELECTION CORRECT	CORRECTION ELECT
ELECTION DERIVE	DIRECTION ALIVE
ELECTION DIRECT	DIRECTION ELECT
ENACT REGION	REACT ENGINE
ENGINE REACT	REGION ENACT
ENOUGH STABLE	STUFF UNABLE
EXCEPTION RESPECT	RECEPTION EXPECT
EXPECT RECEPTION	RESPECT EXCEPTION
FACTOR SESSION	SECTOR FASHION
FASHION MOST	MOTION FAST
FASHION SECTOR	SESSION FACTOR
FAST MOTION	MOST FASHION
FAST POSTER	POST FASTER
FASTER POST	POSTER FAST
FATHER MUSCLE	MOTHER FOSSIL
FIBER LATER	LABOR FIGHTER
FICTION SEX	SECTION FIX
FIGHTER BEND	BETTER FIND
FIGHTER LABOR	LATER FIBER
FIGHTER LAND	LATTER FIND
FIGHTER LANDING	LATTER FINDING
FIGHTER LEND	LETTER FIND
FIGHTER MEETING	METER FIGHTING
FIGHTER VOTING	VOTER FIGHTING
FIGHTING METER	MEETING FIGHTER
FIGHTING SEND	SETTING FIND
FIGHTING VOTER	VOTING FIGHTER
FILM REST	REALM FIST
FIND BETTER	BEND FIGHTER
FIND LANDING	LAND FINDING
FIND LATTER	LAND FIGHTER
FIND LETTER	LEND FIGHTER
FIND SETTING	SEND FIGHTING
FINDING LAND	LANDING FIND
FINDING LATTER	LANDING FIGHTER
FINISH VAST	VANISH FIST
FIST NEXT	NEST FIXED
FIST REALM	REST FILM
FIST TEXT	TEST FIXED
FIST VANISH	VAST FINISH
FIX SECTION	SEX FICTION
FIXED NEST	NEXT FIST
FIXED TEST	TEXT FIST
FLAG DRAWER	DRAG FLOOR
FLASH TREAT	TRASH FLEET
FLASH TRIP	TRASH FLIP
FLEET GRIP	GREET FLIP
FLEET TRASH	TREAT FLASH
FLEET TRIP	TREAT FLIP
FLIGHT QUOTE	QUITE FLOAT
FLIP GREET	GRIP FLEET
FLIP SCORE	SKIP FLOOR
FLIP TRASH	TRIP FLASH
FLIP TREAT	TRIP FLEET
FLOAT QUITE	QUOTE FLIGHT
FLOOR DRAG	DRAWER FLAG
FLOOR SKIP	SCORE FLIP
FORK PARTY	PARK FORTY
FORTY PARK	PARTY FORK
FOSSIL MOTHER	MUSCLE FATHER
FOUND TENDER	TEND FOUNDER
FOUNDER TEND	TENDER FOUND
FRAME BLEND	BLAME FRIEND
FREAK SPEND	SPEAK FRIEND
FRIEND BLAME	BLEND FRAME
FRIEND SPEAK	SPEND FREAK
FUNCTION SAND	SANCTION FUND
FUND LANDING	LAND FUNDING
FUND SANCTION	SAND FUNCTION
FUNDING LAND	LANDING FUND
GLANCE STORY	STANCE GLORY
GLORY STANCE	STORY GLANCE
GOLF SHARED	SHELF GUARD
GRACE PLAIN	PLACE GRAIN
GRACE PLANE	PLACE GRAIN
GRACE PLANT	PLACE GRANT
GRACE PLATE	PLACE GREAT
GRACE SPEAK	SPACE GREEK
GRAIN PLACE	PLAIN GRACE
GRAIN PLANT	PLAIN GRANT
GRAIN PLATE	PLAIN GREAT
GRAM SLAVE	SLAM GRAVE
GRAM SLIP	SLAM GRIP
GRAND STAFF	STAND GRAPH
GRAND STATE	STAND GREAT
GRANT PLACE	PLANT GRACE
GRANT PLAIN	PLANT GRAIN
GRANT PLANE	PLANT GRAIN
GRANT PLATE	PLANT GREAT
GRAPH STAND	STAFF GRAND
GRAPH STATE	STAFF GREAT
GRASS CLEAN	CLASS GREEN
GRASS CLIP	CLASS GRIP
GRASS CLOSE	CLASS GROSS
GRAVE SLAM	SLAVE GRAM
GRAVE SLIP	SLAVE GRIP
GREAT PLACE	PLATE GRACE
GREAT PLAIN	PLATE GRAIN
GREAT PLANE	PLATE GRAIN
GREAT PLANT	PLATE GRANT
GREAT STAFF	STATE GRAPH
GREAT STAND	STATE GRAND
GREEK SPACE	SPEAK GRACE
GREEN CLASS	CLEAN GRASS
GREEN CLIP	CLEAN GRIP
GREEN CLOSE	CLEAN GROSS
GREET FLIP	FLEET GRIP
GRIP CLASS	CLIP GRASS
GRIP CLEAN	CLIP GREEN
GRIP CLOSE	CLIP GROSS
GRIP FLEET	FLIP GREET
GRIP SLAM	SLIP GRAM
GRIP SLAVE	SLIP GRAVE
GROSS CLASS	CLOSE GRASS
GROSS CLEAN	CLOSE GREEN
GROSS CLIP	CLOSE GRIP
GUARD SHELF	SHARED GOLF
HARD COURT	CORD HEART
HARD SORT	SWORD HEART
HEART CORD	COURT HARD
HEART SWORD	SORT HARD
HOLY BEST	BELLY HOST
HOLY VAST	VALLEY HOST
HOLY WRIST	REALLY HOST
HORRIBLE TERROR	TERRIBLE HORROR
HORROR TERRIBLE	TERROR HORRIBLE
HOST BELLY	BEST HOLY
HOST REALLY	WRIST HOLY
HOST VALLEY	VAST HOLY
HUNT CENTER	CENT HUNTER
HUNT COUNTER	COUNT HUNTER
HUNT PAINTER	PAINT HUNTER
HUNT PAINTING	PAINT HUNTING
HUNTER CENT	CENTER HUNT
HUNTER COUNT	COUNTER HUNT
HUNTER PAINT	PAINTER HUNT
HUNTER PAINTING	PAINTER HUNTING
HUNTING PAINT	PAINTING HUNT
HUNTING PAINTER	PAINTING HUNTER
IMPLY SUPPORT	SUPPLY IMPORT
IMPLY SUPPOSE	SUPPLY IMPOSE
IMPORT SUPPLY	SUPPORT IMPLY
IMPORT SUPPOSE	SUPPORT IMPOSE
IMPOSE SUPPLY	SUPPOSE IMPLY
IMPOSE SUPPORT	SUPPOSE IMPORT
INCOME OUTPUT	OUTCOME INPUT
INCOME OUTSIDE	OUTCOME INSIDE
INCREASE DISTANCE	DECREASE INSTANCE
INCREASE DISTANT	DECREASE INSTANT
INCREASE DISTINCT	DECREASE INSTINCT
INDUCE REFORM	REDUCE INFORM
INFORM PERSIST	PERFORM INSIST
INFORM REDUCE	REFORM INDUCE
INITIAL OFFICIALLY	OFFICIAL INITIALLY
INITIALLY OFFICIAL	OFFICIALLY INITIAL
INPUT OUTCOME	OUTPUT INCOME
INPUT OUTSIDE	OUTPUT INSIDE
INSIDE DESTRUCTION	DECIDE INSTRUCTION
INSIDE OUTCOME	OUTSIDE INCOME
INSIDE OUTPUT	OUTSIDE INPUT
INSIST PERFORM	PERSIST INFORM
INSTANCE DECREASE	DISTANCE INCREASE
INSTANCE DISTANT	DISTANCE INSTANT
INSTANCE DISTINCT	DISTANCE INSTINCT
INSTANT DECREASE	DISTANT INCREASE
INSTANT DISTANCE	DISTANT INSTANCE
INSTANT DISTINCT	DISTANT INSTINCT
INSTINCT DECREASE	DISTINCT INCREASE
INSTINCT DISTANCE	DISTINCT INSTANCE
INSTINCT DISTANT	DISTINCT INSTANT
INSTRUCTION DECIDE	DESTRUCTION INSIDE
ISOLATE VIOLATION	VIOLATE ISOLATION
ISOLATION VIOLATE	VIOLATION ISOLATE
JUMP CAST	CAMP JUST
JUMP LAST	LAMP JUST
JUNGLE SINK	SINGLE JUNK
JUNK LIST	LINK JUST
JUNK SINGLE	SINK JUNGLE
JUST CAMP	CAST JUMP
JUST LAMP	LAST JUMP
JUST LINK	LIST JUNK
JUST TESTIFY	TEST JUSTIFY
JUSTIFY TEST	TESTIFY JUST
LABEL BUDDY	BUBBLE LADY
LABEL BUTTER	BUBBLE LATER
LABEL MOTOR	MOBILE LATER
LABEL READY	REBEL LADY
LABOR FIGHTER	FIBER LATER
LADY BUBBLE	BUDDY LABEL
LADY BUTTER	BUDDY LATER
LADY REBEL	READY LABEL
LAMP DUST	DUMP LAST
LAMP JUST	JUMP LAST
LAND BEST	BEND LAST
LAND BETTER	BEND LATTER
LAND FIGHTER	FIND LATTER
LAND FINDING	FIND LANDING
LAND FUNDING	FUND LANDING
LAND TEST	TEND LAST
LANDING FIGHTER	FINDING LATTER
LANDING FIND	FINDING LAND
LANDING FUND	FUNDING LAND
LAST BEND	BEST LAND
LAST BETTER	BEST LATTER
LAST COTTON	COST LATIN
LAST DUMP	DUST LAMP
LAST JUMP	JUST LAMP
LAST MOTOR	MOST LATTER
LAST TEND	TEST LAND
LAST WRITTEN	WRIST LATIN
LATER BUBBLE	BUTTER LABEL
LATER BUDDY	BUTTER LADY
LATER BUSY	BITTER LAZY
LATER FIBER	FIGHTER LABOR
LATER MOBILE	MOTOR LABEL
LATIN BUTTER	BUTTON LATTER
LATIN COST	COTTON LAST
LATIN WRIST	WRITTEN LAST
LATTER BEND	BETTER LAND
LATTER BEST	BETTER LAST
LATTER BUTTON	BUTTER LATIN
LATTER FIND	FIGHTER LAND
LATTER FINDING	FIGHTER LANDING
LATTER MOST	MOTOR LAST
LAUNCH BEST	BENCH LOST
LAZY BITTER	BUSY LATER
LEADING REST	READING LEAST
LEADING WEST	WEDDING LEAST
LEARNER RUNNING	RUNNER LEARNING
LEARNING RUNNER	RUNNING LEARNER
LEAST READING	REST LEADING
LEAST WEDDING	WEST LEADING
LEATHER BOND	BOTHER LEND
LEMON SAND	SALMON LEND
LEND BOTHER	BOND LEATHER
LEND FIGHTER	FIND LETTER
LEND SALMON	SAND LEMON
LETTER FIND	FIGHTER LEND
LETTER RIVAL	WRITER LEVEL
LEVEL WRITER	RIVAL LETTER
LIMIT SUBTLE	SUMMIT LITTLE
LINK BATTLE	BANK LITTLE
LINK JUST	JUNK LIST
LIST CATTLE	CAST LITTLE
LIST JUNK	JUST LINK
LIST NEVER	NEST LIVER
LITTLE BANK	BATTLE LINK
LITTLE CAST	CATTLE LIST
LITTLE SUMMIT	SUBTLE LIMIT
LIVER NEST	NEVER LIST
LIVER SERVING	SERVER LIVING
LIVING SERVER	SERVING LIVER
LOBBY MAKER	MAYBE LOCKER
LOCKER MAYBE	MAKER LOBBY
LOGIC MAGICAL	MAGIC LOGICAL
LOGICAL MAGIC	MAGICAL LOGIC
LORD COST	CARD LOST
LOST BENCH	BEST LAUNCH
LOST CARD	COST LORD
LOVER SERVING	SERVER LOVING
LOVING SERVER	SERVING LOVER
MONDAY CAST	CANDY MUST
MONDAY CASTLE	CANDY MUSCLE
MORALITY READER	REALITY MURDER
MOST BETTER	BEST MOTOR
MOST DOUBLE	DUST MOBILE
MOST FASHION	FAST MOTION
MOST LATTER	LAST MOTOR
MOST PASSION	PAST MOTION
MOST REBEL	REST MOBILE
MOST TABLE	TASTE MOBILE
MOTHER FOSSIL	FATHER MUSCLE
MOTHER WEST	WEATHER MUST
MOTION ACTIVE	ACTION MOTIVE
MOTION ACTOR	ACTION MOTOR
MOTION FAST	FASHION MOST
MOTION NATIVE	NATION MOTIVE
MOTION PAST	PASSION MOST
MOTIVE ACTION	ACTIVE MOTION
MOTIVE ACTOR	ACTIVE MOTOR
MOTIVE NATION	NATIVE MOTION
MOTOR ACTION	ACTOR MOTION
MOTOR ACTIVE	ACTOR MOTIVE
MOTOR BEST	BETTER MOST
MOTOR BUBBLE	BUTTER MOBILE
MOTOR LABEL	LATER MOBILE
MOTOR LAST	LATTER MOST
MURDER REALITY	READER MORALITY
MUSCLE CANDY	CASTLE MONDAY
MUSCLE CAST	CASTLE MUST
MUSCLE FATHER	FOSSIL MOTHER
MUST CANDY	CAST MONDAY
MUST CASTLE	CAST MUSCLE
MUST WEATHER	WEST MOTHER
MUST WHETHER	WEST MOTHER
NATION ACTIVE	ACTION NATIVE
NATION MOTIVE	MOTION NATIVE
NATIVE ACTION	ACTIVE NATION
NATIVE MOTION	MOTIVE NATION
NATURE TV	TEACHER NAVY
NAVY TEACHER	TV NATURE
NEST FIXED	FIST NEXT
NEST LIVER	LIST NEVER
NEST RIVER	WRIST NEVER
NEVER LIST	LIVER NEST
NEVER WRIST	RIVER NEST
NEXT FIST	FIXED NEST
OBSERVE RETAIN	RESERVE OBTAIN
OBTAIN RESERVE	RETAIN OBSERVE
OFFEND SPARE	SPEND AFFAIR
OFFICIAL INITIALLY	INITIAL OFFICIALLY
OFFICIALLY INITIAL	INITIALLY OFFICIAL
OPPOSED CLEAR	CLOSED APPEAR
OUTCOME INPUT	INCOME OUTPUT
OUTCOME INSIDE	INCOME OUTSIDE
OUTPUT INCOME	INPUT OUTCOME
OUTPUT INSIDE	INPUT OUTSIDE
OUTSIDE INCOME	INSIDE OUTCOME
OUTSIDE INPUT	INSIDE OUTPUT
PAINT CENTER	CENT PAINTER
PAINT COUNTER	COUNT PAINTER
PAINT HUNTER	HUNT PAINTER
PAINT HUNTING	HUNT PAINTING
PAINTER CENT	CENTER PAINT
PAINTER COUNT	COUNTER PAINT
PAINTER HUNT	HUNTER PAINT
PAINTER HUNTING	HUNTER PAINTING
PAINTING HUNT	HUNTING PAINT
PAINTING HUNTER	HUNTING PAINTER
PANT REST	RENT PAST
PANT SESSION	CENT PASSION
PANT TEST	TENT PAST
PARK FORTY	FORK PARTY
PART SHORTLY	SHORT PARTLY
PARTLY SHORT	SHORTLY PART
PARTY FORK	FORTY PARK
PASSING MISSION	MISSING PASSION
PASSION CENT	SESSION PANT
PASSION MISSING	MISSION PASSING
PASSION MOST	MOTION PAST
PASSION RETURN	RUSSIAN PATTERN
PAST MOTION	MOST PASSION
PAST RENT	REST PANT
PAST TENT	TEST PANT
PATTERN RUSSIAN	RETURN PASSION
PEACEFUL UNIT	USEFUL PEANUT
PEANUT USEFUL	UNIT PEACEFUL
PERCEIVE RECEPTION	RECEIVE PERCEPTION
PERCEIVE REFORM	RECEIVE PERFORM
PERCEPTION RECEIVE	RECEPTION PERCEIVE
PERCEPTION REFORM	RECEPTION PERFORM
PERFORM INSIST	INFORM PERSIST
PERFORM RECEIVE	REFORM PERCEIVE
PERFORM RECEPTION	REFORM PERCEPTION
PERMISSION COMMIT	COMMISSION PERMIT
PERMISSION COUPLE	COMMISSION PURPLE
PERMIT COMMISSION	COMMIT PERMISSION
PERMIT COUPLE	COMMIT PURPLE
PERSIST INFORM	INSIST PERFORM
PICKUP BANK	BACKUP PINK
PINK BACKUP	BANK PICKUP
PLACE GRAIN	GRACE PLAIN
PLACE GRANT	GRACE PLANT
PLACE GREAT	GRACE PLATE
PLACE SPEED	SPACE PLEAD
PLACE SPOT	SPACE PLOT
PLACE TRAIN	TRACE PLAIN
PLACE TRAIT	TRACE PLATE
PLACE TREASURE	TRACE PLEASURE
PLAIN BREEZE	BRAIN PLEASE
PLAIN GRACE	GRAIN PLACE
PLAIN GRANT	GRAIN PLANT
PLAIN GREAT	GRAIN PLATE
PLAIN TRACE	TRAIN PLACE
PLAIN TRAIT	TRAIN PLATE
PLAIN TREASURE	TRAIN PLEASURE
PLANE BRAIN	BRAIN PLAIN
PLANE BREEZE	BRAIN PLEASE
PLANE DRAIN	DRAIN PLAIN
PLANE GRACE	GRAIN PLACE
PLANE GRAIN	GRAIN PLAIN
PLANE GRANT	GRAIN PLANT
PLANE GREAT	GRAIN PLATE
PLANE TRACE	TRAIN PLACE
PLANE TRAIN	TRAIN PLAIN
PLANE TRAIT	TRAIN PLATE
PLANE TREASURE	TRAIN PLEASURE
PLANT GRACE	GRANT PLACE
PLANT GRAIN	GRANT PLAIN
PLANT GREAT	GRANT PLATE
PLATE GRACE	GREAT PLACE
PLATE GRAIN	GREAT PLAIN
PLATE GRANT	GREAT PLANT
PLATE TRACE	TRAIT PLACE
PLATE TRAIN	TRAIT PLAIN
PLATE TREASURE	TRAIT PLEASURE
PLEAD SPACE	SPEED PLACE
PLEAD SPOT	SPEED PLOT
PLEASE BRAIN	BREEZE PLAIN
PLEASURE TRACE	TREASURE PLACE
PLEASURE TRAIN	TREASURE PLAIN
PLEASURE TRAIT	TREASURE PLATE
PLOT SPACE	SPOT PLACE
PLOT SPEED	SPOT PLEAD
PORCH MARK	MARCH PORK
PORK MARCH	MARK PORCH
POST FASTER	FAST POSTER
POSTER FAST	FASTER POST
PRAYER SPEECH	SPARE PREACH
PREACH SPARE	SPEECH PRAYER
PRESS ASIDE	ASSESS PRIDE
PRICE SLIDE	SLICE PRIDE
PRIDE ASSESS	ASIDE PRESS
PRIDE SLICE	SLIDE PRICE
PRIME CLOUD	CLIMB PROUD
PROUD CLIMB	CLOUD PRIME
PURPLE COMMISSION	COUPLE PERMISSION
PURPLE COMMIT	COUPLE PERMIT
QUEST BRICK	BREAST QUICK
QUEST BRIGHT	BREAST QUITE
QUICK BREAST	BRICK QUEST
QUICK BRIGHT	BRICK QUITE
QUIT SPITE	SPIT QUITE
QUITE BREAST	BRIGHT QUEST
QUITE BRICK	BRIGHT QUICK
QUITE FLOAT	FLIGHT QUOTE
QUITE SPIT	SPITE QUIT
QUOTE FLIGHT	FLOAT QUITE
RALLY BENCH	BELLY RANCH
RALLY SINK	SILLY RANK
RANCH BELLY	BENCH RALLY
RANK SILLY	SINK RALLY
REACT ENGINE	ENACT REGION
READER MORALITY	MURDER REALITY
READING LEAST	LEADING REST
READY BUBBLE	BUDDY REBEL
READY LABEL	LADY REBEL
REALITY MURDER	MORALITY READER
REALLY BEST	BELLY WRIST
REALLY HOST	HOLY WRIST
REALLY VAST	VALLEY WRIST
REALM FIST	FILM REST
REASON DETAIL	DOZEN RETAIL
REBEL BUDDY	BUBBLE READY
REBEL DUST	DOUBLE REST
REBEL LADY	LABEL READY
REBEL MOST	MOBILE REST
REBEL TASTE	TABLE REST
RECEIVE PERCEPTION	PERCEIVE RECEPTION
RECEIVE PERFORM	PERCEIVE REFORM
RECEPTION EXPECT	EXCEPTION RESPECT
RECEPTION PERCEIVE	PERCEPTION RECEIVE
RECEPTION PERFORM	PERCEPTION REFORM
REDUCE INFORM	INDUCE REFORM
REFER DINNER	DIFFER RUNNER
REFORM INDUCE	INFORM REDUCE
REFORM PERCEIVE	PERFORM RECEIVE
REFORM PERCEPTION	PERFORM RECEPTION
REGION ENACT	ENGINE REACT
REMAIN DONOR	DOMAIN RUNNER
RENDER WANT	WANDER RENT
RENT PAST	PANT REST
RENT WANDER	WANT RENDER
RESERVE OBTAIN	OBSERVE RETAIN
RESPECT EXCEPTION	EXPECT RECEPTION
REST DOUBLE	DUST REBEL
REST FILM	FIST REALM
REST LEADING	LEAST READING
REST MOBILE	MOST REBEL
REST PANT	PAST RENT
REST TABLE	TASTE REBEL
RETAIL DOZEN	DETAIL REASON
RETAIN OBSERVE	OBTAIN RESERVE
RETURN PASSION	PATTERN RUSSIAN
RIVAL LETTER	LEVEL WRITER
RIVER CERTAIN	SERVER WRITTEN
RIVER NEST	NEVER WRIST
RUNNER DIFFER	DINNER REFER
RUNNER DOMAIN	DONOR REMAIN
RUNNER LEARNING	LEARNER RUNNING
RUNNING LEARNER	LEARNING RUNNER
RUSSIAN PATTERN	PASSION RETURN
SADLY WIND	WIDELY SAND
SALMON LEND	LEMON SAND
SAMPLE TEND	TEMPLE SAND
SANCTION FUND	FUNCTION SAND
SAND FUNCTION	FUND SANCTION
SAND LEMON	LEND SALMON
SAND TEMPLE	TEND SAMPLE
SAND WIDELY	WIND SADLY
SCALE TRIP	TRAIL SKIP
SCHEME DRAWER	DREAM SCORE
SCHEME DRILL	DREAM SKILL
SCORE DREAM	DRAWER SCHEME
SCORE DRILL	DRAWER SKILL
SCORE FLIP	FLOOR SKIP
SECTION FIX	FICTION SEX
SECTOR FASHION	FACTOR SESSION
SENATE MISSION	MINUTE SESSION
SENATE MIX	MINUTE SEX
SEND BATTLE	BAND SETTLE
SEND BOTTLE	BOND SETTLE
SEND BOX	BOND SEX
SEND FIGHTING	FIND SETTING
SENSE DANCER	DANCE SENSOR
SENSOR CATTLE	CANCER SETTLE
SENSOR DANCE	DANCER SENSE
SERVER LIVING	LIVER SERVING
SERVER LOVING	LOVER SERVING
SERVER WRITTEN	RIVER CERTAIN
SERVING LIVER	LIVING SERVER
SERVING LOVER	LOVING SERVER
SESSION FACTOR	FASHION SECTOR
SESSION MINUTE	MISSION SENATE
SESSION MIX	MISSION SEX
SESSION PANT	PASSION CENT
SETTING FIND	FIGHTING SEND
SETTLE BAND	BATTLE SEND
SETTLE BOND	BOTTLE SEND
SETTLE BOX	BOTTLE SEX
SETTLE CANCER	CATTLE SENSOR
SEX BOND	BOX SEND
SEX BOTTLE	BOX SETTLE
SEX FICTION	FIX SECTION
SEX MINUTE	MIX SENATE
SEX MISSION	MIX SESSION
SHARED GOLF	GUARD SHELF
SHELF GUARD	GOLF SHARED
SHORT PARTLY	PART SHORTLY
SHORTLY PART	PARTLY SHORT
SILENT TACKLE	TALENT CYCLE
SILLY RANK	RALLY SINK
SINGLE JUNK	JUNGLE SINK
SINK JUNGLE	JUNK SINGLE
SINK RALLY	RANK SILLY
SINK TAX	TANK SIX
SIX TANK	TAX SINK
SKILL DRAWER	DRILL SCORE
SKILL DREAM	DRILL SCHEME
SKIP FLOOR	FLIP SCORE
SKIP TRAIL	TRIP SCALE
SLAM GRAVE	GRAM SLAVE
SLAM GRIP	GRAM SLIP
SLAP TRIP	TRAP SLIP
SLAVE BRIDE	BRAVE SLIDE
SLAVE BRIGHT	BRAVE SLIGHT
SLAVE GRAM	GRAVE SLAM
SLAVE GRIP	GRAVE SLIP
SLICE PRIDE	PRICE SLIDE
SLIDE BRAVE	BRIDE SLAVE
SLIDE BRIGHT	BRIDE SLIGHT
SLIDE PRICE	PRIDE SLICE
SLIGHT BRAVE	BRIGHT SLAVE
SLIGHT BRIDE	BRIGHT SLIDE
SLIP GRAM	GRIP SLAM
SLIP GRAVE	GRIP SLAVE
SLIP TRAP	TRIP SLAP
SNAP CREEK	CRAP SNEAK
SNEAK CRAP	CREEK SNAP
SORT CARD	CART SWORD
SORT HARD	HEART SWORD
SPACE GREEK	GRACE SPEAK
SPACE PLEAD	PLACE SPEED
SPACE PLOT	PLACE SPOT
SPACE TREND	TRACE SPEND
SPARE OFFEND	AFFAIR SPEND
SPARE PREACH	PRAYER SPEECH
SPEAK FRIEND	FREAK SPEND
SPEAK GRACE	GREEK SPACE
SPEECH PRAYER	PREACH SPARE
SPEED BLEND	BLEED SPEND
SPEED PLACE	PLEAD SPACE
SPEED PLOT	PLEAD SPOT
SPEND AFFAIR	OFFEND SPARE
SPEND BLEED	BLEND SPEED
SPEND FREAK	FRIEND SPEAK
SPEND TRACE	TREND SPACE
SPIT QUITE	QUIT SPITE
SPITE QUIT	QUITE SPIT
SPOT PLACE	PLOT SPACE
SPOT PLEAD	PLOT SPEED
STABLE ENOUGH	UNABLE STUFF
STACK BLOCK	BLACK STOCK
STACK BLOODY	BLACK STUDY
STACK CREAM	CRACK STEAM
STACK CROP	CRACK STOP
STACK TRAIT	TRACK STATE
STACK TRICK	TRACK STICK
STAFF GRAND	GRAPH STAND
STAFF GREAT	GRAPH STATE
STAIR AWAIT	AWARE STATE
STAIR AWAKE	AWARE STAKE
STAKE AWAIT	AWAKE STATE
STAKE AWARE	AWAKE STAIR
STAKE BRAND	BREAK STAND
STAKE BRICK	BREAK STICK
STANCE GLORY	GLANCE STORY
STAND BREAK	BRAND STAKE
STAND BRICK	BRAND STICK
STAND GRAPH	GRAND STAFF
STAND GREAT	GRAND STATE
STARE AFFAIR	AFFAIR STAIR
STARE AWAIT	AWARE STATE
STARE AWAKE	AWARE STAKE
STARE AWARE	AWARE STAIR
STARE PRAYER	PRAYER STAIR
START APPEAL	APART STEAL
STATE AWAKE	AWAIT STAKE
STATE AWARE	AWAIT STAIR
STATE GRAND	GREAT STAND
STATE GRAPH	GREAT STAFF
STATE TRACK	TRAIT STACK
STATE TRICK	TRAIT STICK
STEAK AWAIT	AWAKE STATE
STEAK AWAKE	AWAKE STAKE
STEAK AWARE	AWAKE STAIR
STEAK BRAND	BREAK STAND
STEAK BREAK	BREAK STAKE
STEAK BRICK	BREAK STICK
STEAL APART	APPEAL START
STEAM CRACK	CREAM STACK
STEAM CROP	CREAM STOP
STEAM DRAWER	DREAM STORE
STEAM DRILL	DREAM STILL
STEAM DROP	DREAM STOP
STEEL APART	APPEAL START
STEEL APPEAL	APPEAL STEAL
STEEL IDEAL	IDEAL STEAL
STICK BRAND	BRICK STAND
STICK BREAK	BRICK STAKE
STICK CLIFF	CLICK STIFF
STICK CLOCK	CLICK STOCK
STICK TRACK	TRICK STACK
STICK TRAIT	TRICK STATE
STIFF CLICK	CLIFF STICK
STIFF CLOCK	CLIFF STOCK
STILL DRAWER	DRILL STORE
STILL DREAM	DRILL STEAM
STILL DROP	DRILL STOP
STOCK BLACK	BLOCK STACK
STOCK BLOODY	BLOCK STUDY
STOCK CLICK	CLOCK STICK
STOCK CLIFF	CLOCK STIFF
STOP CRACK	CROP STACK
STOP CREAM	CROP STEAM
STOP DRAWER	DROP STORE
STOP DREAM	DROP STEAM
STOP DRILL	DROP STILL
STORE DREAM	DRAWER STEAM
STORE DRILL	DRAWER STILL
STORE DROP	DRAWER STOP
STORY GLANCE	GLORY STANCE
STUDY BLACK	BLOODY STACK
STUDY BLOCK	BLOODY STOCK
STUFF UNABLE	ENOUGH STABLE
SUBTLE LIMIT	LITTLE SUMMIT
SUBTLE MANY	METAL SUNNY
SUBTLE MEMORY	METAL SUMMARY
SUBTLE TINY	TITLE SUNNY
SUMMARY MANY	MEMORY SUNNY
SUMMARY METAL	MEMORY SUBTLE
SUMMIT LITTLE	LIMIT SUBTLE
SUNNY MEMORY	MANY SUMMARY
SUNNY METAL	MANY SUBTLE
SUNNY TITLE	TINY SUBTLE
SUPPLY IMPORT	IMPLY SUPPORT
SUPPLY IMPOSE	IMPLY SUPPOSE
SUPPORT IMPLY	IMPORT SUPPLY
SUPPORT IMPOSE	IMPORT SUPPOSE
SUPPOSE IMPLY	IMPOSE SUPPLY
SUPPOSE IMPORT	IMPOSE SUPPORT
SWEET ELITE	ELITE SUITE
SWEET FLEET	FLEET SUITE
SWEET GREET	GREET SUITE
SWEET TREAT	TREAT SUITE
SWORD CART	CARD SORT
SWORD HEART	HARD SORT
TABLE DUST	DOUBLE TASTE
TABLE MOST	MOBILE TASTE
TABLE REST	REBEL TASTE
TACKLE CHUNK	CHUCKLE TANK
TACKLE SILENT	CYCLE TALENT
TALENT CYCLE	SILENT TACKLE
TANK CHUCKLE	CHUNK TACKLE
TANK SIX	SINK TAX
TASTE DOUBLE	DUST TABLE
TASTE MOBILE	MOST TABLE
TASTE REBEL	REST TABLE
TAX SINK	SIX TANK
TEACHER NAVY	NATURE TV
TEMPLE SAND	SAMPLE TEND
TEND FOUNDER	FOUND TENDER
TEND LAST	LAND TEST
TEND SAMPLE	SAND TEMPLE
TENDER FOUND	FOUNDER TEND
TENDER WANT	WANDER TENT
TENT PAST	PANT TEST
TENT WANDER	WANT TENDER
TERRIBLE HORROR	HORRIBLE TERROR
TERROR HORRIBLE	HORROR TERRIBLE
TERROR MIXED	MIRROR TEXT
TEST FIXED	FIST TEXT
TEST JUSTIFY	JUST TESTIFY
TEST LAND	LAST TEND
TEST PANT	PAST TENT
TESTIFY JUST	JUSTIFY TEST
TEXT FIST	FIXED TEST
TEXT MIRROR	MIXED TERROR
THRIVE ALONE	ALIVE THRONE
THRONE ALIVE	ALONE THRIVE
TIMING BOTTLE	BOMBING TITLE
TINY METAL	MANY TITLE
TINY SUBTLE	SUNNY TITLE
TITLE BOMBING	BOTTLE TIMING
TITLE MANY	METAL TINY
TITLE SUNNY	SUBTLE TINY
TRACE PLAIN	PLACE TRAIN
TRACE PLANE	PLACE TRAIN
TRACE PLATE	PLACE TRAIT
TRACE PLEASURE	PLACE TREASURE
TRACE SPEND	SPACE TREND
TRACK ATTEND	ATTACK TREND
TRACK BLADE	BLACK TRADE
TRACK BLEND	BLACK TREND
TRACK STATE	STACK TRAIT
TRACK STICK	STACK TRICK
TRADE BLACK	BLADE TRACK
TRADE BLEND	BLADE TREND
TRAIL SKIP	SCALE TRIP
TRAIN PLACE